fecha,region,pcr_pos,pr_pos,ag_pos,total_pos,pcr_total,pr_total,ag_total,total
2021-01-05,Amazonas,1663,16913,2,18578,8076,76872,6,84948
2021-01-06,Amazonas,1663,16916,4,18583,8076,76872,12,84948
2021-01-07,Amazonas,1711,16923,7,18641,8170,76872,19,85042
2021-01-08,Amazonas,1745,16931,9,18685,8293,76872,20,85165
2021-01-09,Amazonas,1746,16934,9,18689,8321,76872,20,85193
2021-01-10,Amazonas,1746,16935,10,18691,8321,76872,21,85193
2021-01-11,Amazonas,1748,16939,10,18697,8342,76872,21,85214
2021-01-12,Amazonas,1767,16946,20,18733,8402,76872,33,85307
2021-01-13,Amazonas,1788,16972,37,18797,8480,76930,39,85449
2021-01-14,Amazonas,1824,16980,74,18878,8558,76985,82,85625
2021-01-15,Amazonas,1853,16986,79,18918,8636,77034,89,85759
2021-01-16,Amazonas,1910,16993,84,18987,8740,77201,102,86043
2021-01-17,Amazonas,1910,16995,89,18994,8740,77260,107,86107
2021-01-18,Amazonas,1918,17005,89,19012,8741,77315,114,86170
2021-01-19,Amazonas,1918,17032,97,19047,8785,77384,121,86290
2021-01-20,Amazonas,1966,17042,106,19114,8957,77471,150,86578
2021-01-21,Amazonas,2034,17047,114,19195,9117,77647,160,86924
2021-01-22,Amazonas,2068,17055,128,19251,9196,77767,203,87166
2021-01-23,Amazonas,2105,17059,130,19294,9298,77809,207,87314
2021-01-24,Amazonas,2105,17059,130,19294,9298,77823,209,87330
2021-01-25,Amazonas,2137,17065,135,19337,9430,77837,214,87481
2021-01-26,Amazonas,2182,17084,147,19413,9562,77912,227,87701
2021-01-27,Amazonas,2210,17100,151,19461,9694,78018,247,87959
2021-01-28,Amazonas,2292,17115,162,19569,9849,78105,284,88238
2021-01-29,Amazonas,2320,17133,192,19645,9939,78234,330,88503
2021-01-30,Amazonas,2347,17150,204,19701,10028,78368,343,88739
2021-01-31,Amazonas,2347,17150,207,19704,10028,78395,362,88785
2021-02-01,Amazonas,2389,17159,222,19770,10117,78474,395,88986
2021-02-02,Amazonas,2434,17184,251,19869,10118,78591,487,89196
2021-02-03,Amazonas,2470,17195,266,19931,10543,78675,557,89775
2021-02-04,Amazonas,2519,17207,276,20002,10651,78758,627,90036
2021-02-05,Amazonas,2520,17211,298,20029,10652,78849,722,90223
2021-02-06,Amazonas,2535,17227,304,20066,10735,78884,750,90369
2021-02-07,Amazonas,2535,17228,307,20070,10735,78889,760,90384
2021-02-08,Amazonas,2570,17231,318,20119,10835,78920,804,90559
2021-02-09,Amazonas,2598,17245,355,20198,10928,78997,911,90836
2021-02-10,Amazonas,2628,17267,418,20313,11022,79304,1152,91478
2021-02-11,Amazonas,2655,17281,451,20387,11115,79486,1300,91901
2021-02-12,Amazonas,2680,17282,484,20446,11205,79585,1448,92238
2021-02-13,Amazonas,2699,17303,504,20506,11237,79734,1587,92558
2021-02-14,Amazonas,2699,17304,518,20521,11237,79792,1664,92693
2021-02-15,Amazonas,2701,17307,550,20558,11246,79862,1779,92887
2021-02-16,Amazonas,2706,17313,574,20593,11339,79926,1954,93219
2021-02-17,Amazonas,2742,17320,587,20649,11432,79991,2081,93504
2021-02-18,Amazonas,2762,17328,624,20714,11525,80050,2211,93786
2021-02-19,Amazonas,2808,17332,650,20790,11635,80116,2321,94072
2021-02-20,Amazonas,2832,17343,670,20845,11693,80175,2433,94301
2021-02-21,Amazonas,2832,17347,679,20858,11693,80185,2462,94340
2021-02-22,Amazonas,2834,17349,701,20884,11697,80246,2588,94531
2021-02-23,Amazonas,2902,17359,723,20984,11824,80338,2719,94881
2021-02-24,Amazonas,2938,17365,749,21052,11826,80390,2859,95075
2021-02-25,Amazonas,2938,17370,763,21071,11841,80461,3028,95330
2021-02-26,Amazonas,3022,17380,794,21196,12015,80550,3207,95772
2021-02-27,Amazonas,3022,17387,811,21220,12015,80597,3308,95920
2021-02-28,Amazonas,3022,17387,815,21224,12015,80606,3322,95943
2021-03-01,Amazonas,3061,17392,834,21287,12092,80658,3588,96338
2021-03-02,Amazonas,3093,17397,872,21362,12152,80739,3969,96860
2021-03-03,Amazonas,3093,17406,908,21407,12181,80788,4354,97323
2021-03-04,Amazonas,3183,17410,926,21519,12241,80820,4528,97589
2021-03-05,Amazonas,3249,17413,944,21606,12390,80857,4720,97967
2021-03-06,Amazonas,3249,17420,963,21632,12390,80882,4854,98126
2021-03-07,Amazonas,3249,17423,974,21646,12390,80902,4880,98172
2021-03-08,Amazonas,3249,17439,999,21687,12390,81022,4987,98399
2021-03-09,Amazonas,3292,17444,1035,21771,12481,81078,5189,98748
2021-03-10,Amazonas,3323,17447,1062,21832,12720,81153,5426,99299
2021-03-11,Amazonas,3393,17455,1092,21940,12877,81199,5578,99654
2021-03-12,Amazonas,3393,17465,1107,21965,13001,81250,5713,99964
2021-03-13,Amazonas,3393,17466,1136,21995,13001,81297,5859,100157
2021-03-14,Amazonas,3491,17471,1145,22107,13188,81323,5896,100407
2021-03-15,Amazonas,3491,17480,1162,22133,13189,81411,6076,100676
2021-03-16,Amazonas,3517,17495,1223,22235,13215,81491,6388,101094
2021-03-17,Amazonas,3547,17502,1262,22311,13288,81559,6585,101432
2021-03-18,Amazonas,3552,17507,1287,22346,13293,81612,6747,101652
2021-03-19,Amazonas,3563,17519,1322,22404,13335,81689,6927,101951
2021-03-20,Amazonas,3563,17526,1343,22432,13398,81735,7052,102185
2021-03-21,Amazonas,3577,17526,1353,22456,13398,81741,7102,102241
2021-03-22,Amazonas,3615,17536,1414,22565,13436,81836,7366,102638
2021-03-23,Amazonas,3654,17544,1470,22668,13501,81900,7616,103017
2021-01-05,Ancash,6637,24710,55,31402,31043,139943,110,170986
2021-01-06,Ancash,6767,24717,104,31588,31366,140305,208,171671
2021-01-07,Ancash,6814,24744,147,31705,31522,140665,294,172187
2021-01-08,Ancash,6894,24764,208,31866,31746,141027,416,172773
2021-01-09,Ancash,6923,24781,246,31950,31843,141388,492,173231
2021-01-10,Ancash,7058,24783,278,32119,32272,141750,556,174022
2021-01-11,Ancash,7132,24788,318,32238,32547,142112,636,174659
2021-01-12,Ancash,7202,24806,395,32403,32739,142472,3245,178456
2021-01-13,Ancash,7319,24868,468,32655,33086,142765,2045,177896
2021-01-14,Ancash,7393,24893,1192,33478,33269,142998,4378,180645
2021-01-15,Ancash,7468,24921,1279,33668,33547,143620,4646,181813
2021-01-16,Ancash,7584,24947,1382,33913,33888,143844,5015,182747
2021-01-17,Ancash,7760,24957,1436,34153,34567,143956,5197,183720
2021-01-18,Ancash,7836,24980,1503,34319,34740,144125,5387,184252
2021-01-19,Ancash,7921,25014,1651,34586,35115,144470,5577,185162
2021-01-20,Ancash,7936,25030,1743,34709,35170,144812,5983,185965
2021-01-21,Ancash,7939,25054,1878,34871,35179,145113,6587,186879
2021-01-22,Ancash,8090,25082,1960,35132,35683,145373,6968,188024
2021-01-23,Ancash,8122,25104,2101,35327,35859,145584,7131,188574
2021-01-24,Ancash,8206,25110,2175,35491,36100,145753,7442,189295
2021-01-25,Ancash,8230,25124,2253,35607,36152,145922,7725,189799
2021-01-26,Ancash,8410,25156,2370,35936,36204,146098,7867,190169
2021-01-27,Ancash,8459,25176,2560,36195,36256,146368,8431,191055
2021-01-28,Ancash,8474,25206,2680,36360,36284,146676,8573,191533
2021-01-29,Ancash,8577,25241,2816,36634,36129,146913,8748,191790
2021-01-30,Ancash,8676,25266,2925,36867,36455,147127,9409,192991
2021-01-31,Ancash,8901,25274,2973,37148,37181,147255,9689,194125
2021-02-01,Ancash,9057,25294,3063,37414,37692,147480,10251,195423
2021-02-02,Ancash,9157,25327,3240,37724,38084,147703,11025,196812
2021-02-03,Ancash,9214,25364,3403,37981,39318,147926,11775,199019
2021-02-04,Ancash,9359,25402,3585,38346,39780,148123,12686,200589
2021-02-05,Ancash,9464,25406,3735,38605,40161,148246,13608,202015
2021-02-06,Ancash,9624,25421,3823,38868,40798,148360,14101,203259
2021-02-07,Ancash,9694,25431,3923,39048,41125,148425,14522,204072
2021-02-08,Ancash,9748,25444,3984,39176,41439,148506,14949,204894
2021-02-09,Ancash,9812,25467,4136,39415,41702,148620,15843,206165
2021-02-10,Ancash,9832,25496,4307,39635,41789,148771,16972,207532
2021-02-11,Ancash,9900,25521,4470,39891,41983,148925,18178,209086
2021-02-12,Ancash,10014,25531,4608,40153,42451,149048,19437,210936
2021-02-13,Ancash,10027,25561,4760,40348,42509,149179,20580,212268
2021-02-14,Ancash,10095,25566,4809,40470,42794,149262,21080,213136
2021-02-15,Ancash,10119,25585,4906,40610,42896,149395,21799,214090
2021-02-16,Ancash,10164,25594,5068,40826,43203,149840,22898,215941
2021-02-17,Ancash,10215,25645,5208,41068,43418,150016,24091,217525
2021-02-18,Ancash,10266,25659,5340,41265,43722,150143,25163,219028
2021-02-19,Ancash,10284,25670,5461,41415,43800,150454,26147,220401
2021-02-20,Ancash,10348,25699,5556,41603,44074,150527,26985,221586
2021-02-21,Ancash,10385,25705,5610,41700,44232,150596,27316,222144
2021-02-22,Ancash,10386,25742,5748,41876,44234,150784,28314,223332
2021-02-23,Ancash,10443,25759,5903,42105,44495,150871,29525,224891
2021-02-24,Ancash,10465,25771,6038,42274,44507,150973,30503,225983
2021-02-25,Ancash,10528,25784,6195,42507,44684,151234,31491,227409
2021-02-26,Ancash,10578,25804,6341,42723,44943,151330,32668,228941
2021-02-27,Ancash,10619,25818,6459,42896,45070,151373,33556,229999
2021-02-28,Ancash,10646,25824,6523,42993,45125,151427,34055,230607
2021-03-01,Ancash,10646,25843,6653,43142,45146,151504,34928,231578
2021-03-02,Ancash,10646,25851,6821,43318,45146,151582,36105,232833
2021-03-03,Ancash,10646,25865,7006,43517,45182,151659,37461,234302
2021-03-04,Ancash,10651,25878,7153,43682,45182,151714,38524,235420
2021-03-05,Ancash,10689,25897,7264,43850,45285,151953,39534,236772
2021-03-06,Ancash,10707,25908,7446,44061,45396,152091,40658,238145
2021-03-07,Ancash,10707,25909,7505,44121,45396,152097,40993,238486
2021-03-08,Ancash,10751,25914,7636,44301,45575,152150,41918,239643
2021-03-09,Ancash,10778,25937,7880,44595,45693,152343,43231,241267
2021-03-10,Áncash,10801,25958,8049,44808,45784,152689,44533,243006
2021-03-11,Áncash,10811,25974,8275,45060,45816,152891,46008,244715
2021-03-12,Áncash,10817,25992,8417,45226,46392,153075,47424,246891
2021-03-13,Áncash,10817,26011,8589,45417,46392,153419,48965,248776
2021-03-14,Áncash,10915,26017,8715,45647,46394,153688,49998,250080
2021-03-15,Áncash,10924,26040,8974,45938,46522,153779,51451,251752
2021-03-16,Áncash,11035,26064,9307,46406,46883,154016,53173,254072
2021-03-17,Áncash,11121,26077,9589,46787,47183,154262,54993,256438
2021-03-18,Áncash,11241,26092,9830,47163,47694,154346,56433,258473
2021-03-19,Áncash,11263,26102,10093,47458,47828,154643,58002,260473
2021-03-20,Áncash,11263,26117,10394,47774,47948,154752,59489,262189
2021-03-21,Áncash,11337,26129,10524,47990,48113,154783,60148,263044
2021-03-22,Áncash,11439,26139,10776,48354,48449,154903,61652,265004
2021-03-23,Áncash,11548,26151,11196,48895,48493,155052,63796,267341
2021-01-06,Apurimac,1946,5879,1,7826,7089,79589,2,86678
2021-01-07,Apurimac,1994,5886,2,7882,7155,79589,4,86744
2021-01-08,Apurimac,2108,5903,5,8016,7361,79934,10,87295
2021-01-09,Apurimac,2185,5922,7,8114,7473,80278,14,87751
2021-01-10,Apurimac,2268,5935,9,8212,7688,80278,18,87966
2021-01-11,Apurimac,2290,5952,9,8251,7742,80278,18,88020
2021-01-12,Apurimac,2290,5983,12,8285,7747,80278,163,88188
2021-01-13,Apurimac,2367,6030,21,8418,7969,80568,148,88685
2021-01-14,Apurimac,2403,6057,38,8498,8044,80978,329,89351
2021-01-15,Apurimac,2501,6100,47,8648,8306,81363,343,90012
2021-01-16,Apurimac,2544,6120,56,8720,8395,81619,356,90370
2021-01-17,Apurimac,2603,6131,59,8793,8534,81856,359,90749
2021-01-18,Apurimac,2603,6140,65,8808,8536,82027,368,90931
2021-01-19,Apurimac,2644,6174,79,8897,8661,82354,409,91424
2021-01-20,Apurimac,2664,6215,84,8963,8707,82800,438,91945
2021-01-21,Apurimac,2705,6250,104,9059,8900,83261,506,92667
2021-01-22,Apurimac,2733,6275,122,9130,8971,83710,599,93280
2021-01-23,Apurimac,2778,6299,145,9222,9062,84055,627,93744
2021-01-24,Apurimac,2778,6320,151,9249,9063,84292,637,93992
2021-01-25,Apurimac,2822,6332,163,9317,9235,84529,693,94457
2021-01-26,Apurimac,2860,6365,174,9399,9407,84885,715,95007
2021-01-27,Apurimac,2901,6386,193,9480,9579,85170,744,95493
2021-01-28,Apurimac,2905,6406,208,9519,9647,85603,808,96058
2021-01-29,Apurimac,2943,6425,217,9585,10043,85953,863,96859
2021-01-30,Apurimac,2959,6443,230,9632,10102,86237,910,97249
2021-01-31,Apurimac,2959,6467,245,9671,10102,86521,938,97561
2021-02-01,Apurimac,2975,6494,272,9741,10170,86819,974,97963
2021-02-02,Apurimac,3007,6522,303,9832,10286,87144,1077,98507
2021-02-03,Apurimac,3031,6546,343,9920,10207,87371,1189,98767
2021-02-04,Apurimac,3052,6557,383,9992,10260,87584,1266,99110
2021-02-05,Apurimac,3061,6565,425,10051,10306,87827,1373,99506
2021-02-06,Apurimac,3068,6573,452,10093,10346,87964,1449,99759
2021-02-07,Apurimac,3068,6583,493,10144,10346,88173,1563,100082
2021-02-08,Apurimac,3084,6598,525,10207,10395,88373,1658,100426
2021-02-09,Apurimac,3093,6622,594,10309,10423,88685,1887,100995
2021-02-10,Apurimac,3121,6657,636,10414,10520,88950,2038,101508
2021-02-11,Apurimac,3125,6680,687,10492,10570,89232,2276,102078
2021-02-12,Apurimac,3142,6693,728,10563,10641,89548,2531,102720
2021-02-13,Apurimac,3142,6718,764,10624,10641,89698,2682,103021
2021-02-14,Apurimac,3142,6725,780,10647,10641,89774,2753,103168
2021-02-15,Apurimac,3152,6749,806,10707,10684,89931,2852,103467
2021-02-16,Apurimac,3161,6762,850,10773,10727,90219,3044,103990
2021-02-17,Apurimac,3170,6789,895,10854,10773,90451,3220,104444
2021-02-18,Apurimac,3174,6809,937,10920,10804,90650,3410,104864
2021-02-19,Apurimac,3179,6824,986,10989,10845,90821,3611,105277
2021-02-20,Apurimac,3179,6844,1012,11035,10846,90961,3783,105590
2021-02-21,Apurimac,3179,6850,1021,11050,10846,91045,3825,105716
2021-02-22,Apurimac,3188,6860,1034,11082,10891,91178,3906,105975
2021-02-23,Apurimac,3195,6875,1072,11142,10891,91337,4070,106298
2021-02-24,Apurimac,3196,6905,1104,11205,10915,91486,4355,106756
2021-02-25,Apurimac,3198,6920,1162,11280,10958,91611,4670,107239
2021-02-26,Apurimac,3199,6932,1191,11322,10979,91726,4959,107664
2021-02-27,Apurimac,3203,6938,1216,11357,11006,91894,5176,108076
2021-02-28,Apurimac,3203,6941,1235,11379,11006,91983,5249,108238
2021-03-01,Apurimac,3210,6960,1262,11432,11029,92158,5379,108566
2021-03-02,Apurimac,3212,6981,1297,11490,11052,92296,5606,108954
2021-03-03,Apurimac,3212,6998,1330,11540,11085,92415,5904,109404
2021-03-04,Apurimac,3218,7013,1368,11599,11108,92549,6206,109863
2021-03-05,Apurimac,3222,7030,1397,11649,11143,92691,6450,110284
2021-03-06,Apurimac,3222,7044,1440,11706,11143,92809,6674,110626
2021-03-07,Apurimac,3222,7048,1459,11729,11143,92863,6776,110782
2021-03-08,Apurimac,3228,7063,1492,11783,11176,92999,6992,111167
2021-03-09,Apurimac,3240,7085,1538,11863,11211,93196,7295,111702
2021-03-10,Apurímac,3240,7102,1604,11946,11235,93451,7616,112302
2021-03-11,Apurímac,3248,7111,1652,12011,11281,93694,7910,112885
2021-03-12,Apurímac,3252,7121,1683,12056,11301,93846,8084,113231
2021-03-13,Apurímac,3252,7132,1730,12114,11301,94005,8409,113715
2021-03-14,Apurímac,3253,7139,1774,12166,11304,94158,8671,114133
2021-03-15,Apurímac,3269,7152,1820,12241,11347,94359,8934,114640
2021-03-16,Apurímac,3273,7167,1874,12314,11371,94522,9236,115129
2021-03-17,Apurímac,3275,7193,1935,12403,11406,94733,9576,115715
2021-03-18,Apurímac,3284,7215,2019,12518,11491,94909,10163,116563
2021-03-19,Apurímac,3309,7241,2079,12629,11544,95171,10570,117285
2021-03-20,Apurímac,3309,7260,2156,12725,11544,95463,10917,117924
2021-03-21,Apurímac,3313,7271,2188,12772,11564,95716,11138,118418
2021-03-22,Apurímac,3321,7298,2258,12877,11587,95990,11461,119038
2021-03-23,Apurímac,3334,7326,2324,12984,11608,96451,11756,119815
2021-01-05,Arequipa,7583,41148,5,48736,70563,248620,10,319183
2021-01-06,Arequipa,7620,41163,14,48797,71284,248912,28,320196
2021-01-07,Arequipa,7719,41229,19,48967,72183,249205,38,321388
2021-01-08,Arequipa,7830,41239,33,49102,73113,249498,66,322611
2021-01-09,Arequipa,7942,41265,41,49248,74567,249498,82,324065
2021-01-10,Arequipa,7950,41281,47,49278,75048,249498,94,324546
2021-01-11,Arequipa,7986,41327,53,49366,75165,249792,106,324957
2021-01-12,Arequipa,8078,41353,62,49493,76415,250086,2404,328905
2021-01-13,Arequipa,8214,41453,70,49737,78056,250555,3379,331990
2021-01-14,Arequipa,8325,41513,164,50002,78649,250840,7378,336867
2021-01-15,Arequipa,8463,41613,182,50258,80819,251275,7418,339512
2021-01-16,Arequipa,8529,41660,196,50385,81766,251786,7840,341392
2021-01-17,Arequipa,8603,41689,203,50495,82216,252110,7952,342278
2021-01-18,Arequipa,8753,41740,216,50709,83346,252421,8234,344001
2021-01-19,Arequipa,8895,41845,245,50985,85686,252838,8516,347040
2021-01-20,Arequipa,8994,41916,288,51198,86813,253398,9162,349373
2021-01-21,Arequipa,9087,42002,323,51412,88386,254075,9976,352437
2021-01-22,Arequipa,9237,42100,366,51703,90009,254603,10676,355288
2021-01-23,Arequipa,9328,42171,403,51902,91014,254856,10967,356837
2021-01-24,Arequipa,9464,42206,418,52088,92092,255079,11375,358546
2021-01-25,Arequipa,9665,42292,461,52418,93102,255302,11932,360336
2021-01-26,Arequipa,9773,42430,498,52701,94112,255715,12401,362228
2021-01-27,Arequipa,9899,42492,543,52934,95122,256255,12865,364242
2021-01-28,Arequipa,10020,42584,632,53236,95864,256892,13833,366589
2021-01-29,Arequipa,10112,42682,687,53481,97218,257329,14730,369277
2021-01-30,Arequipa,10233,42765,783,53781,98429,257872,15657,371958
2021-01-31,Arequipa,10245,42807,821,53873,98480,258083,15707,372270
2021-02-01,Arequipa,10402,42878,883,54163,99926,258445,16421,374792
2021-02-02,Arequipa,10618,42957,988,54563,101247,259226,17304,377777
2021-02-03,Arequipa,10705,43048,1090,54843,103206,259900,18331,381437
2021-02-04,Arequipa,10810,43115,1211,55136,103800,260524,19301,383625
2021-02-05,Arequipa,10934,43121,1297,55352,104978,261017,20162,386157
2021-02-06,Arequipa,10981,43206,1344,55531,105441,261330,20570,387341
2021-02-07,Arequipa,10987,43235,1395,55617,105495,261567,20846,387908
2021-02-08,Arequipa,11139,43269,1469,55877,106334,261890,21529,389753
2021-02-09,Arequipa,11255,43366,1564,56185,106879,262283,22383,391545
2021-02-10,Arequipa,11381,43477,1712,56570,108406,262923,23965,395294
2021-02-11,Arequipa,11566,43565,1860,56991,109942,263292,25939,399173
2021-02-12,Arequipa,11615,43579,2024,57218,111901,263624,27641,403166
2021-02-13,Arequipa,11681,43722,2141,57544,112928,264257,29152,406337
2021-02-14,Arequipa,11681,43754,2179,57614,113410,264692,29607,407709
2021-02-15,Arequipa,11815,43821,2267,57903,114003,265485,30972,410460
2021-02-16,Arequipa,11923,43837,2355,58115,114529,266106,32459,413094
2021-02-17,Arequipa,12002,43949,2469,58420,116076,266585,33774,416435
2021-02-18,Arequipa,12074,44034,2573,58681,117392,266909,35422,419723
2021-02-19,Arequipa,12159,44050,2718,58927,118639,267245,37289,423173
2021-02-20,Arequipa,12219,44148,2801,59168,120677,267528,38537,426742
2021-02-21,Arequipa,12221,44170,2824,59215,121035,268027,38858,427920
2021-02-22,Arequipa,12291,44212,2940,59443,121849,268370,40777,430996
2021-02-23,Arequipa,12403,44263,3055,59721,123103,268668,42303,434074
2021-02-24,Arequipa,12493,44302,3140,59935,125254,269010,43872,438136
2021-02-25,Arequipa,12621,44343,3243,60207,126719,269273,45785,441777
2021-02-26,Arequipa,12717,44411,3331,60459,128795,269583,47852,446230
2021-02-27,Arequipa,12736,44448,3414,60598,129711,269810,49882,449403
2021-02-28,Arequipa,12768,44470,3475,60713,129970,269936,50503,450409
2021-03-01,Arequipa,12792,44520,3555,60867,131000,270257,52564,453821
2021-03-02,Arequipa,12890,44560,3659,61109,132199,270753,54129,457081
2021-03-03,Arequipa,12912,44603,3746,61261,133893,271127,55948,460968
2021-03-04,Arequipa,12987,44654,3848,61489,135092,271510,57655,464257
2021-03-05,Arequipa,13050,44701,3934,61685,136438,271993,59735,468166
2021-03-06,Arequipa,13085,44744,4003,61832,137382,272330,61084,470796
2021-03-07,Arequipa,13093,44763,4032,61888,137758,272516,61413,471687
2021-03-08,Arequipa,13213,44814,4120,62147,138143,272983,62919,474045
2021-03-09,Arequipa,13272,44854,4221,62347,138778,273651,64658,477087
2021-03-10,Arequipa,13303,44899,4312,62514,140539,274083,66529,481151
2021-03-11,Arequipa,13395,44929,4383,62707,141666,274518,68154,484338
2021-03-12,Arequipa,13438,44964,4438,62840,142473,274766,69548,486787
2021-03-13,Arequipa,13438,45002,4493,62933,142473,275310,71146,488929
2021-03-14,Arequipa,13484,45018,4520,63022,143647,275529,71779,490955
2021-03-15,Arequipa,13576,45046,4575,63197,144395,276268,73155,493818
2021-03-16,Arequipa,13638,45081,4650,63369,147022,276897,75000,498919
2021-03-17,Arequipa,13680,45109,4721,63510,148156,277204,77034,502394
2021-03-18,Arequipa,13745,45136,4816,63697,149484,277508,78667,505659
2021-03-19,Arequipa,13773,45168,4916,63857,151084,277780,80135,508999
2021-03-20,Arequipa,13773,45196,5009,63978,151737,278068,81588,511393
2021-03-21,Arequipa,13831,45213,5062,64106,152021,278297,82217,512535
2021-03-22,Arequipa,13849,45240,5147,64236,152840,278582,84054,515476
2021-03-23,Arequipa,13890,45267,5246,64403,154177,278948,85453,518578
2021-01-05,Ayacucho,2724,12683,3,15410,9341,73423,6,82764
2021-01-06,Ayacucho,2743,12684,6,15433,9396,73423,12,82819
2021-01-07,Ayacucho,2770,12690,10,15470,9442,73423,20,82865
2021-01-08,Ayacucho,2778,12694,19,15491,9495,73423,38,82918
2021-01-09,Ayacucho,2811,12705,20,15536,9562,73423,40,82985
2021-01-10,Ayacucho,2811,12711,31,15553,9563,73423,62,82986
2021-01-11,Ayacucho,2848,12723,35,15606,9635,73423,70,83058
2021-01-12,Ayacucho,2882,12730,59,15671,9698,73423,610,83731
2021-01-13,Ayacucho,2918,12762,81,15761,9777,73627,374,83778
2021-01-14,Ayacucho,2947,12774,163,15884,9805,73811,837,84453
2021-01-15,Ayacucho,2982,12794,187,15963,9883,73981,863,84727
2021-01-16,Ayacucho,3004,12810,199,16013,9950,74150,899,84999
2021-01-17,Ayacucho,3004,12824,205,16033,9950,74217,915,85082
2021-01-18,Ayacucho,3040,12837,239,16116,10026,74369,994,85389
2021-01-19,Ayacucho,3076,12854,261,16191,10102,74565,1073,85740
2021-01-20,Ayacucho,3121,12874,275,16270,10200,74792,1148,86140
2021-01-21,Ayacucho,3161,12888,291,16340,10269,75006,1253,86528
2021-01-22,Ayacucho,3183,12908,319,16410,10331,75183,1386,86900
2021-01-23,Ayacucho,3221,12918,331,16470,10422,75339,1443,87204
2021-01-24,Ayacucho,3221,12924,344,16489,10422,75438,1480,87340
2021-01-25,Ayacucho,3244,12939,359,16542,10471,75537,1555,87563
2021-01-26,Ayacucho,3278,12974,374,16626,10520,75697,1603,87820
2021-01-27,Ayacucho,3315,12997,397,16709,10569,75841,1710,88120
2021-01-28,Ayacucho,3350,13036,415,16801,10651,76065,1855,88571
2021-01-29,Ayacucho,3373,13055,441,16869,10603,76201,1988,88792
2021-01-30,Ayacucho,3409,13085,462,16956,10704,76369,2100,89173
2021-01-31,Ayacucho,3409,13098,488,16995,10704,76456,2156,89316
2021-02-01,Ayacucho,3439,13115,511,17065,10763,76607,2283,89653
2021-02-02,Ayacucho,3472,13150,535,17157,10857,76765,2427,90049
2021-02-03,Ayacucho,3499,13168,567,17234,10995,76890,2561,90446
2021-02-04,Ayacucho,3533,13199,591,17323,11094,77022,2691,90807
2021-02-05,Ayacucho,3572,13206,641,17419,11189,77252,2859,91300
2021-02-06,Ayacucho,3599,13220,660,17479,11261,77307,2945,91513
2021-02-07,Ayacucho,3599,13232,687,17518,11261,77463,3041,91765
2021-02-08,Ayacucho,3634,13246,712,17592,11343,77508,3177,92028
2021-02-09,Ayacucho,3679,13265,752,17696,11440,77612,3429,92481
2021-02-10,Ayacucho,3709,13291,808,17808,11515,77796,3707,93018
2021-02-11,Ayacucho,3747,13307,857,17911,11594,77937,4011,93542
2021-02-12,Ayacucho,3769,13309,910,17988,11670,78077,4350,94097
2021-02-13,Ayacucho,3808,13343,947,18098,11743,78172,4600,94515
2021-02-14,Ayacucho,3808,13350,979,18137,11743,78256,4695,94694
2021-02-15,Ayacucho,3839,13359,1028,18226,11797,78329,4911,95037
2021-02-16,Ayacucho,3873,13364,1082,18319,11869,78459,5162,95490
2021-02-17,Ayacucho,3915,13391,1117,18423,11952,78598,5391,95941
2021-02-18,Ayacucho,3940,13414,1185,18539,12019,78744,5666,96429
2021-02-19,Ayacucho,3983,13419,1233,18635,12104,78853,5888,96845
2021-02-20,Ayacucho,4016,13452,1292,18760,12205,78977,6150,97332
2021-02-21,Ayacucho,4016,13468,1330,18814,12205,79052,6276,97533
2021-02-22,Ayacucho,4058,13484,1369,18911,12300,79143,6483,97926
2021-02-23,Ayacucho,4101,13503,1412,19016,12397,79275,6708,98380
2021-02-24,Ayacucho,4130,13516,1479,19125,12484,79332,6959,98775
2021-02-25,Ayacucho,4171,13530,1536,19237,12577,79515,7164,99256
2021-02-26,Ayacucho,4219,13547,1608,19374,12658,79605,7473,99736
2021-02-27,Ayacucho,4259,13564,1648,19471,12762,79697,7804,100263
2021-02-28,Ayacucho,4259,13576,1673,19508,12762,79761,7969,100492
2021-03-01,Ayacucho,4301,13580,1763,19644,12843,79804,8268,100915
2021-03-02,Ayacucho,4328,13600,1826,19754,12920,79901,8628,101449
2021-03-03,Ayacucho,4328,13610,1876,19814,13025,79995,8892,101912
2021-03-04,Ayacucho,4430,13623,1946,19999,13102,80083,9267,102452
2021-03-05,Ayacucho,4454,13644,2013,20111,13175,80160,9685,103020
2021-03-06,Ayacucho,4492,13659,2113,20264,13267,80234,10133,103634
2021-03-07,Ayacucho,4492,13668,2138,20298,13267,80310,10267,103844
2021-03-08,Ayacucho,4518,13680,2195,20393,13314,80409,10548,104271
2021-03-09,Ayacucho,4559,13706,2289,20554,13397,80552,11008,104957
2021-03-10,Ayacucho,4593,13723,2372,20688,13478,80649,11498,105625
2021-03-11,Ayacucho,4637,13744,2423,20804,13571,80815,11965,106351
2021-03-12,Ayacucho,4659,13768,2508,20935,13621,80909,12339,106869
2021-03-13,Ayacucho,4659,13785,2595,21039,13621,81032,12844,107497
2021-03-14,Ayacucho,4660,13800,2657,21117,13621,81142,13085,107848
2021-03-15,Ayacucho,4731,13811,2730,21272,13784,81347,13384,108515
2021-03-16,Ayacucho,4766,13830,2812,21408,13853,81431,13736,109020
2021-03-17,Ayacucho,4803,13853,2911,21567,13933,81546,14021,109500
2021-03-18,Ayacucho,4827,13869,3009,21705,13991,81643,14406,110040
2021-03-19,Ayacucho,4855,13883,3085,21823,14050,81807,14702,110559
2021-03-20,Ayacucho,4855,13894,3162,21911,14146,81887,15003,111036
2021-03-21,Ayacucho,4897,13900,3202,21999,14146,81931,15183,111260
2021-03-22,Ayacucho,4918,13920,3286,22124,14195,81996,15494,111685
2021-03-23,Ayacucho,4965,13935,3363,22263,14267,82045,15800,112112
2021-01-06,Cajamarca,4061,21668,3,25732,21040,122927,6,143967
2021-01-07,Cajamarca,4147,21716,6,25869,21299,123382,12,144681
2021-01-08,Cajamarca,4184,21721,7,25912,21517,123834,14,145351
2021-01-09,Cajamarca,4285,21752,10,26047,21728,123834,20,145562
2021-01-10,Cajamarca,4313,21753,12,26078,21784,123834,24,145618
2021-01-11,Cajamarca,4313,21780,14,26107,21784,123834,28,145618
2021-01-12,Cajamarca,4353,21793,16,26162,21924,123834,227,145985
2021-01-13,Cajamarca,4384,21887,22,26293,22053,124243,789,147085
2021-01-14,Cajamarca,4405,21940,50,26395,22118,124557,1722,148397
2021-01-15,Cajamarca,4445,22000,58,26503,22271,124944,1893,149108
2021-01-16,Cajamarca,4574,22041,60,26675,22551,125332,1953,149836
2021-01-17,Cajamarca,4831,22077,64,26972,23431,125544,2406,151381
2021-01-18,Cajamarca,4872,22106,72,27050,23577,125771,2526,151874
2021-01-19,Cajamarca,4957,22161,82,27200,23744,126072,2646,152462
2021-01-20,Cajamarca,4974,22225,90,27289,23877,126377,3078,153332
2021-01-21,Cajamarca,5072,22287,97,27456,24279,126656,3096,154031
2021-01-22,Cajamarca,5121,22342,110,27573,24655,127016,3339,155010
2021-01-23,Cajamarca,5176,22407,119,27702,25080,127366,3821,156267
2021-01-24,Cajamarca,5202,22444,126,27772,25188,127594,4021,156803
2021-01-25,Cajamarca,5233,22477,133,27843,25335,127822,4221,157378
2021-01-26,Cajamarca,5332,22584,147,28063,25482,128221,4413,158116
2021-01-27,Cajamarca,5368,22649,156,28173,25629,128539,4770,158938
2021-01-28,Cajamarca,5440,22761,179,28380,25948,129279,4816,160043
2021-01-29,Cajamarca,5516,22829,212,28557,25927,129803,5059,160789
2021-01-30,Cajamarca,5601,22875,243,28719,26156,130158,5753,162067
2021-01-31,Cajamarca,5623,22915,250,28788,26301,130402,6106,162809
2021-02-01,Cajamarca,5645,22951,261,28857,26435,130694,6408,163537
2021-02-02,Cajamarca,5712,23007,291,29010,26792,130977,6659,164428
2021-02-03,Cajamarca,5758,23089,327,29174,27672,131357,7008,166037
2021-02-04,Cajamarca,5796,23186,362,29344,27931,131784,7321,167036
2021-02-05,Cajamarca,5896,23203,405,29504,28281,132187,7688,168156
2021-02-06,Cajamarca,5957,23251,433,29641,28620,132335,7950,168905
2021-02-07,Cajamarca,5970,23293,460,29723,28702,132715,8892,170309
2021-02-08,Cajamarca,6003,23355,484,29842,28879,132906,9153,170938
2021-02-09,Cajamarca,6081,23412,528,30021,29128,133170,9437,171735
2021-02-10,Cajamarca,6151,23487,605,30243,29391,133726,9971,173088
2021-02-11,Cajamarca,6187,23543,652,30382,29610,134086,10687,174383
2021-02-12,Cajamarca,6246,23560,700,30506,29762,134536,11371,175669
2021-02-13,Cajamarca,6316,23640,774,30730,29940,134804,11962,176706
2021-02-14,Cajamarca,6316,23665,806,30787,30010,135005,12398,177413
2021-02-15,Cajamarca,6343,23711,855,30909,30198,135300,12872,178370
2021-02-16,Cajamarca,6398,23728,909,31035,30350,135978,13357,179685
2021-02-17,Cajamarca,6485,23843,959,31287,30537,136378,14132,181047
2021-02-18,Cajamarca,6594,23898,1006,31498,30722,136726,14618,182066
2021-02-19,Cajamarca,6665,23927,1083,31675,30903,136931,15388,183222
2021-02-20,Cajamarca,6736,24003,1132,31871,31128,137164,15777,184069
2021-02-21,Cajamarca,6768,24030,1168,31966,31500,137323,16370,185193
2021-02-22,Cajamarca,6811,24073,1233,32117,31649,137564,16901,186114
2021-02-23,Cajamarca,6994,24117,1286,32397,31987,137881,17506,187374
2021-02-24,Cajamarca,7140,24163,1329,32632,32297,138139,18345,188781
2021-02-25,Cajamarca,7288,24221,1369,32878,32546,138411,19000,189957
2021-02-26,Cajamarca,7335,24256,1428,33019,32709,138624,19573,190906
2021-02-27,Cajamarca,7434,24304,1459,33197,32933,139062,20026,192021
2021-02-28,Cajamarca,7440,24323,1489,33252,33027,139231,20374,192632
2021-03-01,Cajamarca,7513,24365,1536,33414,33168,139501,20986,193655
2021-03-02,Cajamarca,7665,24411,1594,33670,33490,139745,21689,194924
2021-03-03,Cajamarca,7677,24443,1647,33767,33572,140041,22252,195865
2021-03-04,Cajamarca,7932,24465,1716,34113,33894,140215,22783,196892
2021-03-05,Cajamarca,8060,24496,1798,34354,34142,140502,23332,197976
2021-03-06,Cajamarca,8283,24512,1864,34659,34470,140631,23767,198868
2021-03-07,Cajamarca,8283,24526,1898,34707,34482,140747,24023,199252
2021-03-08,Cajamarca,8365,24555,1983,34903,34614,140946,24703,200263
2021-03-09,Cajamarca,8571,24575,2062,35208,34962,141230,25259,201451
2021-03-10,Cajamarca,8720,24611,2122,35453,35228,141484,25757,202469
2021-03-11,Cajamarca,8749,24656,2257,35662,35275,141740,26782,203797
2021-03-12,Cajamarca,8754,24675,2320,35749,35476,141889,27353,204718
2021-03-13,Cajamarca,8754,24696,2445,35895,35476,142061,28139,205676
2021-03-14,Cajamarca,8829,24703,2549,36081,35636,142253,28721,206610
2021-03-15,Cajamarca,9001,24721,2640,36362,36205,142491,29292,207988
2021-03-16,Cajamarca,9087,24756,2859,36702,36736,142834,30361,209931
2021-03-17,Cajamarca,9190,24795,2972,36957,37106,143106,31224,211436
2021-03-18,Cajamarca,9346,24823,3081,37250,37426,143335,32136,212897
2021-03-19,Cajamarca,9418,24858,3215,37491,37749,143567,33362,214678
2021-03-20,Cajamarca,9418,24893,3355,37666,38000,143859,34254,216113
2021-03-21,Cajamarca,9526,24926,3506,37958,38093,144154,35326,217573
2021-03-22,Cajamarca,9556,24977,3683,38216,38381,144437,36652,219470
2021-03-23,Cajamarca,9598,25017,3887,38502,38590,144762,37882,221234
2021-01-05,Callao,11256,32567,13,43836,51623,137066,26,188689
2021-01-06,Callao,11339,32572,24,43935,51848,137066,48,188914
2021-01-07,Callao,11372,32598,37,44007,52021,137066,74,189087
2021-01-08,Callao,11445,32611,44,44100,52232,137066,88,189298
2021-01-09,Callao,11506,32642,57,44205,52408,137066,114,189474
2021-01-10,Callao,11596,32650,57,44303,52637,137066,114,189703
2021-01-11,Callao,11662,32674,67,44403,52882,137066,134,189948
2021-01-12,Callao,11872,32694,82,44648,53472,137066,695,191233
2021-01-13,Callao,11898,32758,103,44759,53582,137395,862,191839
2021-01-14,Callao,11944,32794,234,44972,53733,137609,1891,193233
2021-01-15,Callao,12041,32827,269,45137,54024,137893,2079,193996
2021-01-16,Callao,12215,32856,293,45364,54683,138206,2316,195205
2021-01-17,Callao,12441,32895,308,45644,55241,138410,2456,196107
2021-01-18,Callao,12546,32924,341,45811,55586,138667,2606,196859
2021-01-19,Callao,12680,32973,377,46030,56022,138893,2756,197671
2021-01-20,Callao,12697,33029,420,46146,56170,139372,3182,198724
2021-01-21,Callao,12772,33080,470,46322,56432,139680,3592,199704
2021-01-22,Callao,12968,33134,518,46620,56974,140082,3661,200717
2021-01-23,Callao,13088,33166,565,46819,57584,140301,3959,201844
2021-01-24,Callao,13238,33186,575,46999,57971,140420,4121,202512
2021-01-25,Callao,13271,33207,610,47088,58068,140539,4380,202987
2021-01-26,Callao,13525,33259,671,47455,58165,140727,4698,203590
2021-01-27,Callao,13733,33298,729,47760,58262,140991,5091,204344
2021-01-28,Callao,13925,33365,783,48073,58851,141355,5188,205394
2021-01-29,Callao,14088,33428,849,48365,57571,141644,5615,204830
2021-01-30,Callao,14118,33455,925,48498,57948,142040,6108,206096
2021-01-31,Callao,14447,33472,948,48867,58823,142243,6342,207408
2021-02-01,Callao,14577,33505,1088,49170,59197,142691,6933,208821
2021-02-02,Callao,14795,33542,1248,49585,59851,142989,7652,210492
2021-02-03,Callao,14872,33589,1402,49863,62076,143400,8406,213882
2021-02-04,Callao,15037,33637,1598,50272,62492,143626,9035,215153
2021-02-05,Callao,15172,33644,1752,50568,63288,143902,9953,217143
2021-02-06,Callao,15391,33684,1820,50895,63902,143946,10295,218143
2021-02-07,Callao,15499,33696,1865,51060,64166,143993,10634,218793
2021-02-08,Callao,15609,33721,1962,51292,64533,144144,11211,219888
2021-02-09,Callao,15727,33755,2146,51628,65016,144269,12139,221424
2021-02-10,Callao,15918,33811,2372,52101,65583,144607,13528,223718
2021-02-11,Callao,16031,33869,2551,52451,65940,144798,14981,225719
2021-02-12,Callao,16160,33876,2774,52810,66277,145063,16569,227909
2021-02-13,Callao,16246,33959,2984,53189,66584,145249,17752,229585
2021-02-14,Callao,16278,33973,3018,53269,66736,145283,18061,230080
2021-02-15,Callao,16337,34010,3199,53546,66956,145457,19211,231624
2021-02-16,Callao,16422,34025,3366,53813,67382,145698,20512,233592
2021-02-17,Callao,16600,34109,3564,54273,67848,146027,21806,235681
2021-02-18,Callao,16729,34156,3726,54611,68319,146222,23115,237656
2021-02-19,Callao,16775,34167,3919,54861,68438,146449,24256,239143
2021-02-20,Callao,17052,34245,4095,55392,69544,146735,25224,241503
2021-02-21,Callao,17331,34254,4131,55716,70630,146854,25538,243022
2021-02-22,Callao,17389,34307,4258,55954,70769,147178,26615,244562
2021-02-23,Callao,17584,34337,4444,56365,71509,147238,27791,246538
2021-02-24,Callao,18184,34372,4621,57177,72989,147490,29032,249511
2021-02-25,Callao,18341,34407,4784,57532,73467,147564,30251,251282
2021-02-26,Callao,18543,34430,4921,57894,74066,147710,31357,253133
2021-02-27,Callao,18679,34458,5027,58164,74422,147888,32320,254630
2021-02-28,Callao,18785,34464,5045,58294,74821,147910,32755,255486
2021-03-01,Callao,18847,34491,5194,58532,74965,148080,33834,256879
2021-03-02,Callao,18980,34523,5314,58817,75224,148143,34834,258201
2021-03-03,Callao,19005,34570,5417,58992,75605,148420,35956,259981
2021-03-04,Callao,19305,34602,5569,59476,75953,148558,37226,261737
2021-03-05,Callao,19535,34653,5701,59889,76871,148662,38413,263946
2021-03-06,Callao,19740,34670,5825,60235,77590,148853,39535,265978
2021-03-07,Callao,19907,34673,5849,60429,78185,148875,39771,266831
2021-03-08,Callao,19965,34701,6008,60674,78374,148974,40928,268276
2021-03-09,Callao,20139,34742,6194,61075,78761,149082,42397,270240
2021-03-10,Callao,20322,34766,6355,61443,79366,149173,43897,272436
2021-03-11,Callao,20387,34813,6561,61761,79663,149229,45393,274285
2021-03-12,Callao,20462,34848,6673,61983,80108,149399,46483,275990
2021-03-13,Callao,20462,34880,6845,62187,80108,149523,48018,277649
2021-03-14,Callao,20560,34895,6927,62382,80579,149541,48907,279027
2021-03-15,Callao,20618,34913,7153,62684,80792,149790,50772,281354
2021-03-16,Callao,20759,34935,7365,63059,81060,149882,52287,283229
2021-03-17,Callao,20920,34973,7561,63454,81857,149965,53846,285668
2021-03-18,Callao,21428,34988,7720,64136,84598,150010,55426,290034
2021-03-19,Callao,22189,35018,7927,65134,88485,150219,56862,295566
2021-03-20,Callao,22220,35035,8097,65352,89661,150245,58155,298061
2021-03-21,Callao,22611,35042,8145,65798,90856,150296,58633,299785
2021-03-22,Callao,23042,35060,8328,66430,92881,150414,60082,303377
2021-03-23,Callao,23666,35081,8579,67326,96010,150488,61636,308134
2021-01-05,Cusco,6778,18805,4,25587,24663,139911,8,164574
2021-01-06,Cusco,6824,18815,12,25651,24801,139911,24,164712
2021-01-07,Cusco,6833,18835,16,25684,24806,140151,32,164957
2021-01-08,Cusco,6886,18857,19,25762,24977,140151,38,165128
2021-01-09,Cusco,6929,18881,26,25836,25225,140151,52,165376
2021-01-10,Cusco,6930,18901,33,25864,25230,140151,66,165381
2021-01-11,Cusco,6949,18930,35,25914,25345,140389,70,165734
2021-01-12,Cusco,6951,18956,38,25945,25346,140389,474,166209
2021-01-13,Cusco,7002,19031,43,26076,25495,140748,444,166687
2021-01-14,Cusco,7015,19085,97,26197,25566,141078,975,167619
2021-01-15,Cusco,7082,19165,108,26355,25691,141554,1026,168271
2021-01-16,Cusco,7121,19231,112,26464,25824,143133,1074,170031
2021-01-17,Cusco,7165,19259,116,26540,25949,143602,1095,170646
2021-01-18,Cusco,7271,19283,124,26678,26324,143849,1168,171341
2021-01-19,Cusco,7339,19344,144,26827,26549,144247,1241,172037
2021-01-20,Cusco,7378,19392,165,26935,26669,144653,1302,172624
2021-01-21,Cusco,7409,19456,185,27050,26772,145176,1408,173356
2021-01-22,Cusco,7534,19514,212,27260,27205,145617,1459,174281
2021-01-23,Cusco,7555,19554,230,27339,27335,145941,1542,174818
2021-01-24,Cusco,7556,19594,244,27394,27363,146131,1651,175145
2021-01-25,Cusco,7646,19644,265,27555,27684,146321,1723,175728
2021-01-26,Cusco,7666,19754,301,27721,28005,146723,1888,176616
2021-01-27,Cusco,7741,19812,333,27886,28326,147022,2040,177388
2021-01-28,Cusco,7781,19873,402,28056,28353,147497,2278,178128
2021-01-29,Cusco,7960,19939,478,28377,29460,148144,2628,180232
2021-01-30,Cusco,8094,20016,571,28681,29988,148658,3213,181859
2021-01-31,Cusco,8293,20064,629,28986,30424,148986,3570,182980
2021-02-01,Cusco,8432,20108,688,29228,30812,149310,4093,184215
2021-02-02,Cusco,8610,20165,777,29552,31538,149735,4754,186027
2021-02-03,Cusco,8713,20236,900,29849,31275,150244,5419,186938
2021-02-04,Cusco,8771,20273,1014,30058,31490,150693,6041,188224
2021-02-05,Cusco,8865,20307,1120,30292,31836,151022,6821,189679
2021-02-06,Cusco,8936,20363,1165,30464,32084,151209,7162,190455
2021-02-07,Cusco,8936,20401,1237,30574,32084,151437,7757,191278
2021-02-08,Cusco,9074,20445,1301,30820,32443,151619,8115,192177
2021-02-09,Cusco,9107,20495,1412,31014,32517,151848,8996,193361
2021-02-10,Cusco,9208,20554,1568,31330,32756,152227,10046,195029
2021-02-11,Cusco,9299,20611,1716,31626,32996,152663,11227,196886
2021-02-12,Cusco,9418,20625,1813,31856,33336,152939,12053,198328
2021-02-13,Cusco,9491,20713,1917,32121,33669,153323,12961,199953
2021-02-14,Cusco,9512,20739,1972,32223,33722,153490,13237,200449
2021-02-15,Cusco,9590,20769,2098,32457,33875,153750,13878,201503
2021-02-16,Cusco,9694,20792,2236,32722,34131,153982,14767,202880
2021-02-17,Cusco,9755,20861,2344,32960,34362,154209,15700,204271
2021-02-18,Cusco,9821,20889,2433,33143,34568,154411,16675,205654
2021-02-19,Cusco,9893,20934,2553,33380,34781,154672,17734,207187
2021-02-20,Cusco,10000,21000,2690,33690,34965,154886,18736,208587
2021-02-21,Cusco,10000,21037,2754,33791,34965,155046,19102,209113
2021-02-22,Cusco,10075,21077,2880,34032,35201,155295,19724,210220
2021-02-23,Cusco,10158,21135,3024,34317,35384,155514,20794,211692
2021-02-24,Cusco,10244,21165,3139,34548,35637,155752,21986,213375
2021-02-25,Cusco,10335,21209,3290,34834,35940,156007,23190,215137
2021-02-26,Cusco,10411,21240,3402,35053,36147,156194,24457,216798
2021-02-27,Cusco,10434,21279,3512,35225,36187,156396,25472,218055
2021-02-28,Cusco,10489,21313,3613,35415,36334,156604,25895,218833
2021-03-01,Cusco,10575,21334,3762,35671,36551,156846,26722,220119
2021-03-02,Cusco,10644,21381,3916,35941,36696,157064,27758,221518
2021-03-03,Cusco,10644,21417,4055,36116,36835,157351,28855,223041
2021-03-04,Cusco,10832,21439,4205,36476,36980,157839,30216,225035
2021-03-05,Cusco,10925,21474,4358,36757,37305,158205,31365,226875
2021-03-06,Cusco,11005,21497,4514,37016,37583,158317,32362,228262
2021-03-07,Cusco,11005,21508,4580,37093,37583,158419,33080,229082
2021-03-08,Cusco,11041,21539,4732,37312,37698,158645,34206,230549
2021-03-09,Cusco,11138,21569,4915,37622,38043,158995,35681,232719
2021-03-10,Cusco,11234,21609,5121,37964,38267,159371,36990,234628
2021-03-11,Cusco,11317,21629,5319,38265,38506,160011,38539,237056
2021-03-12,Cusco,11347,21671,5426,38444,38683,160384,40170,239237
2021-03-13,Cusco,11347,21700,5589,38636,38683,160597,41948,241228
2021-03-14,Cusco,11370,21725,5682,38777,38683,160732,42720,242135
2021-03-15,Cusco,11486,21743,5839,39068,39094,160990,44079,244163
2021-03-16,Cusco,11591,21771,6066,39428,39369,161136,45304,245809
2021-03-17,Cusco,11660,21804,6281,39745,39539,161309,46754,247602
2021-03-18,Cusco,11760,21834,6451,40045,39896,161519,48233,249648
2021-03-19,Cusco,11835,21858,6653,40346,40125,161705,49644,251474
2021-03-20,Cusco,11835,21880,6836,40551,40345,161806,51222,253373
2021-03-21,Cusco,11929,21896,6951,40776,40345,161905,51922,254172
2021-03-22,Cusco,12045,21938,7158,41141,40586,162097,53211,255894
2021-03-23,Cusco,12210,21968,7382,41560,40682,162259,54517,257458
2021-01-05,Huancavelica,1058,6876,1,7935,6169,54774,2,60943
2021-01-06,Huancavelica,1058,6877,1,7936,6169,54890,2,61059
2021-01-07,Huancavelica,1058,6883,2,7943,6169,54890,4,61059
2021-01-08,Huancavelica,1058,6888,2,7948,6169,54890,4,61059
2021-01-09,Huancavelica,1058,6889,3,7950,6169,54890,6,61059
2021-01-10,Huancavelica,1058,6889,3,7950,6169,54890,6,61059
2021-01-11,Huancavelica,1058,6895,5,7958,6169,54890,10,61059
2021-01-12,Huancavelica,1058,6896,8,7962,6169,54890,88,61147
2021-01-13,Huancavelica,1098,6906,9,8013,6290,54973,335,61598
2021-01-14,Huancavelica,1098,6917,19,8034,6292,55059,816,62167
2021-01-15,Huancavelica,1098,6925,23,8046,6292,55165,917,62374
2021-01-16,Huancavelica,1098,6929,30,8057,6292,55232,1005,62529
2021-01-17,Huancavelica,1098,6931,33,8062,6292,55268,1057,62617
2021-01-18,Huancavelica,1098,6933,34,8065,6292,55347,1070,62709
2021-01-19,Huancavelica,1163,6935,38,8136,6492,55446,1083,63021
2021-01-20,Huancavelica,1181,6937,48,8166,6559,55520,1099,63178
2021-01-21,Huancavelica,1195,6946,58,8199,6583,55721,1124,63428
2021-01-22,Huancavelica,1195,6955,74,8224,6583,55842,1144,63569
2021-01-23,Huancavelica,1195,6968,83,8246,6583,55994,1278,63855
2021-01-24,Huancavelica,1195,6969,91,8255,6585,56114,1319,64018
2021-01-25,Huancavelica,1195,6973,103,8271,6585,56234,1332,64151
2021-01-26,Huancavelica,1195,6983,116,8294,6585,56331,1394,64310
2021-01-27,Huancavelica,1204,6989,125,8318,6585,56395,1476,64456
2021-01-28,Huancavelica,1243,7002,133,8378,6715,56489,1551,64755
2021-01-29,Huancavelica,1330,7021,151,8502,6584,56703,1653,64940
2021-01-30,Huancavelica,1330,7031,161,8522,6621,56776,1713,65110
2021-01-31,Huancavelica,1340,7035,170,8545,6637,56949,1726,65312
2021-02-01,Huancavelica,1340,7044,183,8567,6637,57099,1771,65507
2021-02-02,Huancavelica,1346,7059,196,8601,6638,57200,1851,65689
2021-02-03,Huancavelica,1356,7081,208,8645,6692,57352,1958,66002
2021-02-04,Huancavelica,1375,7094,222,8691,6732,57481,2145,66358
2021-02-05,Huancavelica,1375,7105,251,8731,6732,57564,2290,66586
2021-02-06,Huancavelica,1382,7122,268,8772,6754,57661,2439,66854
2021-02-07,Huancavelica,1393,7136,282,8811,6772,57803,2706,67281
2021-02-08,Huancavelica,1394,7147,303,8844,6774,57886,2807,67467
2021-02-09,Huancavelica,1394,7158,321,8873,6774,58042,2888,67704
2021-02-10,Huancavelica,1394,7177,340,8911,6774,58186,3038,67998
2021-02-11,Huancavelica,1436,7198,362,8996,6909,58266,3172,68347
2021-02-12,Huancavelica,1451,7205,396,9052,6977,58361,3497,68835
2021-02-13,Huancavelica,1451,7220,416,9087,6977,58458,3647,69082
2021-02-14,Huancavelica,1451,7229,437,9117,6977,58605,3751,69333
2021-02-15,Huancavelica,1469,7239,449,9157,7035,58699,3831,69565
2021-02-16,Huancavelica,1492,7248,461,9201,7105,58963,4004,70072
2021-02-17,Huancavelica,1503,7280,499,9282,7150,59375,4330,70855
2021-02-18,Huancavelica,1506,7294,527,9327,7190,59558,4574,71322
2021-02-19,Huancavelica,1519,7301,556,9376,7231,59764,4813,71808
2021-02-20,Huancavelica,1526,7324,578,9428,7294,60008,4932,72234
2021-02-21,Huancavelica,1526,7327,593,9446,7294,60054,5006,72354
2021-02-22,Huancavelica,1526,7337,616,9479,7296,60140,5140,72576
2021-02-23,Huancavelica,1526,7344,636,9506,7296,60271,5316,72883
2021-02-24,Huancavelica,1532,7355,653,9540,7343,60391,5484,73218
2021-02-25,Huancavelica,1540,7362,663,9565,7366,60475,5829,73670
2021-02-26,Huancavelica,1540,7373,679,9592,7366,60611,5952,73929
2021-02-27,Huancavelica,1540,7379,700,9619,7366,60671,6073,74110
2021-02-28,Huancavelica,1540,7381,710,9631,7366,60723,6229,74318
2021-03-01,Huancavelica,1540,7386,738,9664,7366,60870,6366,74602
2021-03-02,Huancavelica,1543,7393,766,9702,7387,60937,6531,74855
2021-03-03,Huancavelica,1543,7403,787,9733,7412,61057,6755,75224
2021-03-04,Huancavelica,1546,7410,821,9777,7433,61138,6957,75528
2021-03-05,Huancavelica,1546,7423,836,9805,7433,61276,7129,75838
2021-03-06,Huancavelica,1547,7433,850,9830,7454,61373,7441,76268
2021-03-07,Huancavelica,1547,7437,861,9845,7454,61443,7659,76556
2021-03-08,Huancavelica,1547,7457,890,9894,7454,61552,7808,76814
2021-03-09,Huancavelica,1550,7472,906,9928,7470,61644,8092,77206
2021-03-10,Huancavelica,1550,7497,934,9981,7470,61778,8433,77681
2021-03-11,Huancavelica,1554,7505,957,10016,7493,61860,8868,78221
2021-03-12,Huancavelica,1556,7518,980,10054,7563,62027,9136,78726
2021-03-13,Huancavelica,1556,7521,1007,10084,7563,62116,9588,79267
2021-03-14,Huancavelica,1565,7524,1034,10123,7563,62156,9759,79478
2021-03-15,Huancavelica,1565,7545,1063,10173,7564,62394,9939,79897
2021-03-16,Huancavelica,1567,7557,1080,10204,7589,62521,10187,80297
2021-03-17,Huancavelica,1572,7564,1104,10240,7614,62627,10461,80702
2021-03-18,Huancavelica,1580,7570,1133,10283,7659,62745,10653,81057
2021-03-19,Huancavelica,1586,7581,1181,10348,7682,62840,10933,81455
2021-03-20,Huancavelica,1586,7589,1212,10387,7682,62908,11141,81731
2021-03-21,Huancavelica,1586,7590,1252,10428,7682,62967,11858,82507
2021-03-22,Huancavelica,1586,7594,1284,10464,7682,63036,12319,83037
2021-03-23,Huancavelica,1586,7612,1330,10528,7705,63104,12570,83379
2021-01-05,Huanuco,2319,18411,2,20732,11770,98191,4,109961
2021-01-06,Huanuco,2450,18438,6,20894,12032,98402,12,110131
2021-01-07,Huanuco,2453,18467,15,20935,12039,98402,30,110441
2021-01-08,Huanuco,2463,18485,36,20984,12068,98614,72,110682
2021-01-09,Huanuco,2506,18519,56,21081,12179,98827,112,111006
2021-01-10,Huanuco,2609,18529,79,21217,12276,98827,158,111103
2021-01-11,Huanuco,2625,18544,88,21257,12324,98827,176,111151
2021-01-12,Huanuco,2676,18574,112,21362,12455,99040,151,111646
2021-01-13,Huanuco,2738,18632,128,21498,12598,99288,240,112126
2021-01-14,Huanuco,2743,18667,278,21688,12607,99422,538,112567
2021-01-15,Huanuco,2743,18707,295,21745,12607,99614,558,112779
2021-01-16,Huanuco,2794,18750,309,21853,12706,99855,581,113142
2021-01-17,Huanuco,2903,18780,331,22014,12953,99966,616,113535
2021-01-18,Huanuco,2947,18815,345,22107,13046,100109,644,113799
2021-01-19,Huanuco,3030,18869,373,22272,13225,100277,658,114160
2021-01-20,Huanuco,3031,18906,388,22325,13330,100504,713,114547
2021-01-21,Huanuco,3106,18942,414,22462,13642,100690,754,115086
2021-01-22,Huanuco,3107,18994,445,22546,13643,100880,812,115335
2021-01-23,Huanuco,3107,19027,495,22629,13643,101038,872,115553
2021-01-24,Huanuco,3107,19066,579,22752,13644,101239,1098,115981
2021-01-25,Huanuco,3107,19097,628,22832,13644,101440,1284,116368
2021-01-26,Huanuco,3107,19167,677,22951,13644,101634,1340,116618
2021-01-27,Huanuco,3107,19222,738,23067,13644,101880,1583,117107
2021-01-28,Huanuco,3107,19265,814,23186,13644,102170,1675,117489
2021-01-29,Huanuco,3107,19316,868,23291,13903,102402,1904,118209
2021-01-30,Huanuco,3107,19345,887,23339,13903,102625,2046,118574
2021-01-31,Huanuco,3107,19366,910,23383,14010,102758,2147,118915
2021-02-01,Huanuco,3107,19400,965,23472,14010,102959,2216,119185
2021-02-02,Huanuco,3107,19431,1036,23574,14195,103099,2296,119590
2021-02-03,Huanuco,3107,19461,1094,23662,14239,103314,2536,120089
2021-02-04,Huanuco,3107,19488,1133,23728,14544,103487,2776,120807
2021-02-05,Huanuco,3107,19498,1178,23783,14592,103745,3114,121451
2021-02-06,Huanuco,3107,19551,1220,23878,14759,103800,3255,121814
2021-02-07,Huanuco,3107,19589,1271,23967,14759,104112,3470,122341
2021-02-08,Huanuco,3107,19613,1316,24036,14759,104191,3649,122599
2021-02-09,Huanuco,3107,19634,1386,24127,14867,104297,3989,123153
2021-02-10,Huanuco,3107,19670,1462,24239,14897,104481,4661,124039
2021-02-11,Huanuco,3107,19707,1518,24332,14958,104626,4990,124574
2021-02-12,Huanuco,3107,19727,1572,24406,14986,104820,5328,125134
2021-02-13,Huanuco,3107,19760,1619,24486,14986,104937,5688,125611
2021-02-14,Huanuco,3107,19788,1648,24543,14986,105032,5826,125844
2021-02-15,Huanuco,3107,19804,1685,24596,14986,105096,6072,126154
2021-02-16,Huanuco,3107,19807,1724,24638,15007,105162,6399,126568
2021-02-17,Huanuco,3107,19857,1767,24731,15007,105270,6685,126962
2021-02-18,Huanuco,3107,19890,1797,24794,15007,105417,7082,127506
2021-02-19,Huanuco,3107,19908,1851,24866,15007,105499,7389,127895
2021-02-20,Huanuco,3107,19936,1891,24934,15007,105627,7811,128445
2021-02-21,Huanuco,3107,19946,1924,24977,15007,105675,8014,128696
2021-02-22,Huanuco,3107,19956,1966,25029,15048,105745,8319,129112
2021-02-23,Huanuco,3107,19973,2001,25081,15096,105845,8587,129528
2021-02-24,Huanuco,3107,19994,2030,25131,15096,105949,8913,129958
2021-02-25,Huanuco,3107,20009,2063,25179,15166,106048,9242,130456
2021-02-26,Huanuco,3107,20026,2091,25224,15312,106140,9590,131042
2021-02-27,Huanuco,3107,20031,2121,25259,15537,106183,9824,131544
2021-02-28,Huanuco,3107,20041,2138,25286,15537,106219,9942,131698
2021-03-01,Huanuco,3107,20047,2164,25318,15537,106267,10263,132067
2021-03-02,Huanuco,3107,20062,2195,25364,15630,106321,10661,132612
2021-03-03,Huanuco,3107,20071,2220,25398,15740,106369,11205,133314
2021-03-04,Huanuco,3107,20076,2248,25431,15833,106421,11631,133885
2021-03-05,Huanuco,3107,20088,2277,25472,15835,106486,12050,134371
2021-03-06,Huanuco,3107,20096,2306,25509,15835,106532,12573,134940
2021-03-07,Huanuco,3107,20101,2328,25536,15835,106563,12833,135231
2021-03-08,Huanuco,3107,20113,2358,25578,15835,106636,13143,135614
2021-03-09,Huanuco,3107,20133,2392,25632,15835,106719,13725,136279
2021-03-10,Huanuco,3107,20145,2434,25686,15835,106774,14394,137003
2021-03-11,Huanuco,3107,20154,2480,25741,15876,106838,14981,137695
2021-03-12,Huanuco,3107,20165,2508,25780,16001,106999,15560,138560
2021-03-13,Huanuco,3107,20177,2540,25824,16001,107209,16087,139297
2021-03-14,Huanuco,3107,20181,2559,25847,16001,107270,16260,139531
2021-03-15,Huanuco,3107,20201,2594,25902,16001,107392,16695,140088
2021-03-16,Huanuco,3107,20217,2638,25962,16073,107578,17152,140803
2021-03-17,Huanuco,3107,20227,2670,26004,16185,107662,17629,141476
2021-03-18,Huanuco,3107,20237,2707,26051,16230,107716,18007,141953
2021-03-19,Huanuco,3107,20250,2763,26120,16230,107788,18431,142449
2021-03-20,Huanuco,3107,20260,2810,26177,16253,107844,18793,142890
2021-03-21,Huanuco,3107,20267,2842,26216,16253,107918,19161,143332
2021-03-22,Huanuco,3107,20273,2902,26282,16253,107989,19556,143798
2021-03-23,Huanuco,3107,20281,2968,26356,16284,108062,19927,144273
2021-01-05,Ica,4192,28107,19,32318,15787,136909,38,152696
2021-01-06,Ica,4226,28112,28,32366,15862,137252,56,153114
2021-01-07,Ica,4269,28131,43,32443,15948,137595,86,153543
2021-01-08,Ica,4307,28136,55,32498,16036,137938,110,153974
2021-01-09,Ica,4337,28158,64,32559,16067,138278,128,154345
2021-01-10,Ica,4363,28163,72,32598,16126,138278,144,154404
2021-01-11,Ica,4386,28203,104,32693,16185,138619,208,154804
2021-01-12,Ica,4422,28209,144,32775,16319,138960,346,155625
2021-01-13,Ica,4444,28298,161,32903,16355,139163,537,156055
2021-01-14,Ica,4527,28316,360,33203,16491,139344,1155,156990
2021-01-15,Ica,4578,28360,393,33331,16645,139565,1308,157518
2021-01-16,Ica,4641,28388,455,33484,16753,139774,1385,157912
2021-01-17,Ica,4680,28405,540,33625,16827,139788,1555,158170
2021-01-18,Ica,4718,28459,580,33757,16909,140067,1675,158651
2021-01-19,Ica,4738,28516,663,33917,16975,140231,1795,159001
2021-01-20,Ica,4746,28580,724,34050,16991,140467,1989,159447
2021-01-21,Ica,4813,28620,795,34228,17128,140771,2248,160147
2021-01-22,Ica,4845,28677,877,34399,17231,140973,2524,160728
2021-01-23,Ica,4862,28710,934,34506,17263,141047,2624,160934
2021-01-24,Ica,4891,28730,970,34591,17286,141073,2793,161152
2021-01-25,Ica,4910,28792,1021,34723,17321,141099,3073,161493
2021-01-26,Ica,4926,28900,1090,34916,17356,141284,3163,161803
2021-01-27,Ica,5013,28941,1190,35144,17391,141435,3298,162124
2021-01-28,Ica,5118,28994,1286,35398,17639,141568,3425,162632
2021-01-29,Ica,5233,29050,1396,35679,17570,141721,3569,162860
2021-01-30,Ica,5235,29116,1483,35834,17573,141861,3968,163402
2021-01-31,Ica,5255,29129,1526,35910,17618,141887,4174,163679
2021-02-01,Ica,5420,29193,1614,36227,18030,142127,4585,164742
2021-02-02,Ica,5575,29266,1712,36553,18387,142309,5030,165726
2021-02-03,Ica,5641,29321,1839,36801,18710,142532,5439,166681
2021-02-04,Ica,5735,29361,1972,37068,18983,142702,6181,167866
2021-02-05,Ica,5786,29378,2137,37301,19125,142857,6909,168891
2021-02-06,Ica,5826,29433,2174,37433,19249,142900,7113,169262
2021-02-07,Ica,5855,29452,2215,37522,19326,142932,7423,169681
2021-02-08,Ica,5891,29474,2277,37642,19538,142976,7821,170335
2021-02-09,Ica,5891,29512,2381,37784,19546,143053,8420,171019
2021-02-10,Ica,5935,29574,2531,38040,19649,143308,9360,172317
2021-02-11,Ica,6018,29634,2665,38317,19885,143623,10118,173626
2021-02-12,Ica,6053,29650,2826,38529,19994,143849,10980,174823
2021-02-13,Ica,6057,29727,2944,38728,20279,144037,11624,175940
2021-02-14,Ica,6083,29747,2988,38818,20721,144066,11875,176662
2021-02-15,Ica,6086,29802,3110,38998,20727,144255,12588,177570
2021-02-16,Ica,6144,29839,3248,39231,20834,145127,13520,179481
2021-02-17,Ica,6166,29944,3368,39478,20902,145613,14399,180914
2021-02-18,Ica,6171,29985,3515,39671,20922,145745,15540,182207
2021-02-19,Ica,6201,30002,3598,39801,21025,145850,16308,183183
2021-02-20,Ica,6220,30075,3699,39994,21085,145931,17247,184263
2021-02-21,Ica,6242,30091,3739,40072,21180,145964,17658,184802
2021-02-22,Ica,6252,30142,3865,40259,21251,146038,18534,185823
2021-02-23,Ica,6258,30184,4039,40481,21286,146145,19570,187001
2021-02-24,Ica,6287,30220,4148,40655,21403,146447,20374,188224
2021-02-25,Ica,6304,30266,4232,40802,21507,146665,21075,189247
2021-02-26,Ica,6326,30320,4310,40956,21643,146844,21772,190259
2021-02-27,Ica,6352,30353,4357,41062,21701,146976,22320,190997
2021-02-28,Ica,6361,30378,4397,41136,21730,146995,22589,191314
2021-03-01,Ica,6392,30402,4491,41285,21875,147185,23393,192453
2021-03-02,Ica,6393,30448,4601,41442,21893,147234,24201,193328
2021-03-03,Ica,6393,30477,4654,41524,21956,147317,25056,194329
2021-03-04,Ica,6431,30502,4720,41653,21974,147410,25802,195186
2021-03-05,Ica,6438,30513,4776,41727,22013,147503,26398,195914
2021-03-06,Ica,6494,30536,4843,41873,22174,147582,27075,196831
2021-03-07,Ica,6515,30551,4867,41933,22240,147587,27313,197140
2021-03-08,Ica,6525,30571,4959,42055,22281,147628,28218,198127
2021-03-09,Ica,6536,30593,5064,42193,22315,147705,29099,199119
2021-03-10,Ica,6566,30618,5144,42328,22395,147888,30104,200387
2021-03-11,Ica,6572,30637,5225,42434,22450,148010,31184,201644
2021-03-12,Ica,6576,30649,5278,42503,22487,148105,32050,202642
2021-03-13,Ica,6576,30667,5338,42581,22487,148330,33014,203831
2021-03-14,Ica,6600,30674,5383,42657,22558,148410,33442,204410
2021-03-15,Ica,6610,30689,5467,42766,22840,148652,34129,205621
2021-03-16,Ica,6653,30729,5569,42951,23119,148908,35424,207451
2021-03-17,Ica,6666,30757,5646,43069,23347,149146,36262,208755
2021-03-18,Ica,6689,30787,5766,43242,23492,149488,37144,210124
2021-03-19,Ica,6711,30812,5853,43376,23655,149662,38082,211399
2021-03-20,Ica,6711,30834,5908,43453,23690,149705,38550,211945
2021-03-21,Ica,6764,30835,5927,43526,23874,149789,38739,212402
2021-03-22,Ica,6764,30865,6026,43655,24076,149822,39361,213259
2021-03-23,Ica,6764,30905,6098,43767,24080,149952,40003,214035
2021-01-05,Junin,3323,25342,1,28666,17183,154032,2,171215
2021-01-06,Junin,3397,25366,4,28767,17394,154746,8,172140
2021-01-07,Junin,3428,25458,10,28896,17578,155460,20,173038
2021-01-08,Junin,3447,25516,13,28976,17692,156171,26,173863
2021-01-09,Junin,3448,25605,20,29073,17951,156883,40,174834
2021-01-10,Junin,3488,25644,23,29155,17978,156883,46,174861
2021-01-11,Junin,3576,25727,36,29339,18403,156883,72,175286
2021-01-12,Junin,3815,25785,54,29654,19217,157596,675,177488
2021-01-13,Junin,3946,26070,68,30084,19664,158285,1273,179222
2021-01-14,Junin,4027,26215,153,30395,19892,158832,2853,181577
2021-01-15,Junin,4155,26397,173,30725,20427,159610,3140,183177
2021-01-16,Junin,4225,26584,196,31005,20812,160199,3407,184418
2021-01-17,Junin,4225,26643,207,31075,20816,160527,3607,184950
2021-01-18,Junin,4329,26734,218,31281,21172,160943,3832,185947
2021-01-19,Junin,4486,26915,245,31646,21665,161554,4057,187276
2021-01-20,Junin,4601,27093,267,31961,22063,162266,4647,188976
2021-01-21,Junin,4688,27282,314,32284,22393,162981,5027,190401
2021-01-22,Junin,4750,27471,368,32589,22751,163650,5458,191859
2021-01-23,Junin,4930,27608,409,32947,23385,164092,5789,193266
2021-01-24,Junin,4930,27686,419,33035,23389,164431,6053,193873
2021-01-25,Junin,4986,27821,468,33275,23639,164770,6316,194725
2021-01-26,Junin,5151,28168,513,33832,23889,165624,6995,196508
2021-01-27,Junin,5280,28403,573,34256,24139,166473,7648,198260
2021-01-28,Junin,5318,28580,641,34539,24362,167235,8368,199965
2021-01-29,Junin,5442,28792,683,34917,24202,167852,8930,200984
2021-01-30,Junin,5443,28949,738,35130,24231,168433,9299,201963
2021-01-31,Junin,5443,29024,783,35250,24231,168733,9443,202407
2021-02-01,Junin,5500,29193,846,35539,24405,169475,9785,203665
2021-02-02,Junin,5624,29419,921,35964,25029,170259,9891,205179
2021-02-03,Junin,5677,29577,996,36250,25839,170857,10768,207464
2021-02-04,Junin,5716,29803,1109,36628,25991,171586,11728,209305
2021-02-05,Junin,5869,29876,1217,36962,26613,172302,12581,211496
2021-02-06,Junin,5923,30101,1281,37305,26750,172636,13017,212403
2021-02-07,Junin,5932,30206,1335,37473,26771,172982,13408,213161
2021-02-08,Junin,6127,30335,1414,37876,27652,173396,14172,215220
2021-02-09,Junin,6161,30563,1558,38282,27855,174144,15116,217115
2021-02-10,Junin,6285,30829,1732,38846,28388,175058,16599,220045
2021-02-11,Junin,6346,31028,1884,39258,28832,175780,17907,222519
2021-02-12,Junin,6397,31082,2041,39520,29116,176529,19166,224811
2021-02-13,Junin,6426,31321,2142,39889,29320,176979,19880,226179
2021-02-14,Junin,6434,31375,2189,39998,29340,177191,20290,226821
2021-02-15,Junin,6476,31550,2314,40340,29669,177796,21112,228577
2021-02-16,Junin,6627,31638,2456,40721,30090,178571,22373,231034
2021-02-17,Junin,6693,31941,2596,41230,30418,179256,23691,233365
2021-02-18,Junin,6743,32047,2710,41500,30675,179706,25076,235457
2021-02-19,Junin,6799,32115,2807,41721,30988,180108,26083,237179
2021-02-20,Junin,6824,32318,2941,42083,31191,180381,27172,238744
2021-02-21,Junin,6824,32358,2976,42158,31193,180566,27667,239426
2021-02-22,Junin,6871,32488,3121,42480,31591,180850,28819,241260
2021-02-23,Junin,6912,32597,3238,42747,31926,181126,30140,243192
2021-02-24,Junin,6972,32706,3342,43020,32321,181499,31214,245034
2021-02-25,Junin,7021,32802,3440,43263,32571,181905,32477,246953
2021-02-26,Junin,7069,32896,3547,43512,32912,182515,33319,248746
2021-02-27,Junin,7080,32973,3639,43692,33095,182750,34088,249933
2021-02-28,Junin,7081,33000,3676,43757,33103,182934,34527,250564
2021-03-01,Junin,7133,33071,3786,43990,33311,183175,35528,252014
2021-03-02,Junin,7191,33162,3899,44252,33596,183455,37046,254097
2021-03-03,Junin,7202,33253,4022,44477,33919,183781,38483,256183
2021-03-04,Junin,7291,33336,4142,44769,34204,184154,40118,258476
2021-03-05,Junin,7330,33428,4245,45003,34492,184470,41622,260584
2021-03-06,Junin,7334,33526,4329,45189,34640,184829,42890,262359
2021-03-07,Junin,7334,33566,4366,45266,34640,185029,43475,263144
2021-03-08,Junin,7387,33622,4460,45469,34922,185424,44725,265071
2021-03-09,Junin,7438,33721,4573,45732,35142,185833,46804,267779
2021-03-10,Junin,7481,33811,4665,45957,35387,186285,49383,271055
2021-03-11,Junin,7536,33902,4741,46179,35554,186933,52518,275005
2021-03-12,Junin,7593,33985,4816,46394,35782,187259,54503,277544
2021-03-13,Junin,7593,34072,4886,46551,35782,187612,57435,280829
2021-03-14,Junin,7600,34119,4930,46649,36138,187832,58404,282374
2021-03-15,Junin,7649,34194,5022,46865,36556,188159,60205,284920
2021-03-16,Junin,7722,34297,5131,47150,36875,188587,62788,288250
2021-03-17,Junin,7734,34394,5282,47410,36976,189025,64389,290390
2021-03-18,Junin,7808,34484,5413,47705,37321,189688,65873,292882
2021-03-19,Junin,7855,34541,5526,47922,37570,190142,67630,295342
2021-03-20,Junin,7855,34620,5660,48135,37616,190469,69482,297567
2021-03-21,Junin,7862,34662,5715,48239,37621,190699,70414,298734
2021-03-22,Junin,7868,34729,5856,48453,37743,190973,71729,300445
2021-03-23,Junin,7944,34798,6038,48780,37986,191494,73323,302803
2021-01-05,La Libertad,5348,32431,5,37784,27372,160927,10,188299
2021-01-06,La Libertad,5435,32444,8,37887,27784,160927,16,188711
2021-01-07,La Libertad,5455,32465,14,37934,28057,160927,28,188984
2021-01-08,La Libertad,5484,32476,15,37975,28210,160927,30,189137
2021-01-09,La Libertad,5534,32510,19,38063,28332,161131,38,189463
2021-01-10,La Libertad,5544,32513,21,38078,28444,161131,42,189575
2021-01-11,La Libertad,5570,32531,25,38126,28671,161131,50,189802
2021-01-12,La Libertad,5615,32548,30,38193,28822,161131,526,190479
2021-01-13,La Libertad,5694,32614,35,38343,29100,161361,854,191315
2021-01-14,La Libertad,5752,32673,82,38507,29202,161618,1766,192586
2021-01-15,La Libertad,5838,32735,89,38662,29502,161875,1777,193154
2021-01-16,La Libertad,5875,32764,97,38736,29582,162025,1793,193400
2021-01-17,La Libertad,5886,32781,102,38769,29635,162137,1937,193709
2021-01-18,La Libertad,5890,32818,111,38819,29779,162327,2045,194151
2021-01-19,La Libertad,5920,32872,122,38914,30061,162569,2153,194783
2021-01-20,La Libertad,5970,32925,133,39028,30282,162848,2381,195511
2021-01-21,La Libertad,6044,32970,149,39163,30405,163149,2402,195956
2021-01-22,La Libertad,6062,33041,169,39272,30491,163450,2608,196549
2021-01-23,La Libertad,6115,33074,185,39374,30906,163610,2846,197362
2021-01-24,La Libertad,6124,33103,188,39415,30957,163854,2977,197788
2021-01-25,La Libertad,6154,33145,202,39501,31015,164098,3108,198221
2021-01-26,La Libertad,6208,33209,209,39626,31073,164308,3308,198689
2021-01-27,La Libertad,6273,33287,237,39797,31131,164556,3684,199371
2021-01-28,La Libertad,6287,33335,276,39898,31338,164701,4024,200063
2021-01-29,La Libertad,6295,33386,321,40002,30710,164856,4476,200042
2021-01-30,La Libertad,6397,33430,383,40210,31075,165122,4760,200957
2021-01-31,La Libertad,6397,33455,403,40255,31075,165368,4921,201364
2021-02-01,La Libertad,6424,33508,457,40389,31293,165576,5367,202236
2021-02-02,La Libertad,6544,33574,519,40637,31545,165859,5469,202873
2021-02-03,La Libertad,6574,33646,606,40826,32252,166093,6144,204489
2021-02-04,La Libertad,6593,33695,671,40959,32284,166266,6775,205325
2021-02-05,La Libertad,6657,33711,745,41113,32364,166422,7212,205998
2021-02-06,La Libertad,6734,33771,787,41292,32619,166469,7453,206541
2021-02-07,La Libertad,6750,33798,826,41374,32803,166597,7788,207188
2021-02-08,La Libertad,6769,33827,863,41459,32905,166728,8160,207793
2021-02-09,La Libertad,6815,33848,952,41615,33062,166836,8712,208610
2021-02-10,La Libertad,6912,33907,1076,41895,33685,167040,9629,210354
2021-02-11,La Libertad,6994,33943,1167,42104,33951,167153,10534,211638
2021-02-12,La Libertad,7077,33960,1258,42295,34320,167260,11317,212897
2021-02-13,La Libertad,7185,34014,1345,42544,34393,167406,12174,213973
2021-02-14,La Libertad,7185,34036,1384,42605,34519,167460,12518,214497
2021-02-15,La Libertad,7231,34060,1470,42761,34821,167554,13240,215615
2021-02-16,La Libertad,7315,34072,1576,42963,35306,167623,14160,217089
2021-02-17,La Libertad,7444,34178,1660,43282,36399,167758,15181,219338
2021-02-18,La Libertad,7523,34221,1752,43496,36714,167880,16264,220858
2021-02-19,La Libertad,7581,34243,1829,43653,37181,168008,17188,222377
2021-02-20,La Libertad,7616,34304,1935,43855,37484,168059,18294,223837
2021-02-21,La Libertad,7644,34321,2015,43980,37704,168198,18887,224789
2021-02-22,La Libertad,7657,34394,2195,44246,38003,168389,19966,226358
2021-02-23,La Libertad,7736,34453,2353,44542,38474,168464,21115,228053
2021-02-24,La Libertad,7790,34485,2542,44817,38875,168533,22311,229719
2021-02-25,La Libertad,7830,34518,2752,45100,38997,168613,23815,231425
2021-02-26,La Libertad,7878,34571,2975,45424,39256,168667,25549,233472
2021-02-27,La Libertad,7964,34605,3137,45706,39727,168726,26660,235113
2021-02-28,La Libertad,7982,34616,3201,45799,39765,168757,27041,235563
2021-03-01,La Libertad,7988,34645,3355,45988,40036,168795,27919,236750
2021-03-02,La Libertad,8043,34677,3509,46229,40382,168863,29185,238430
2021-03-03,La Libertad,8058,34710,3627,46395,41125,168955,30420,240500
2021-03-04,La Libertad,8207,34751,3742,46700,41471,169016,31729,242216
2021-03-05,La Libertad,8211,34778,3882,46871,41841,169085,32784,243710
2021-03-06,La Libertad,8263,34804,4029,47096,42009,169176,33880,245065
2021-03-07,La Libertad,8268,34810,4106,47184,42151,169191,34463,245805
2021-03-08,La Libertad,8273,34832,4232,47337,42250,169243,35514,247007
2021-03-09,La Libertad,8321,34857,4391,47569,42334,169302,36519,248155
2021-03-10,La Libertad,8396,34904,4592,47892,42641,169408,37908,249957
2021-03-11,La Libertad,8494,34947,4753,48194,43120,169508,39274,251902
2021-03-12,La Libertad,8536,34970,4908,48414,43604,169692,40846,254142
2021-03-13,La Libertad,8536,35002,5092,48630,43604,170024,42166,255794
2021-03-14,La Libertad,8659,35016,5155,48830,43949,170055,42793,256797
2021-03-15,La Libertad,8693,35031,5336,49060,44356,170165,43966,258487
2021-03-16,La Libertad,8751,35056,5619,49426,44732,170233,45955,260920
2021-03-17,La Libertad,8830,35096,5838,49764,45224,170324,47999,263547
2021-03-18,La Libertad,8954,35124,5994,50072,45762,170364,49319,265445
2021-03-19,La Libertad,9106,35140,6233,50479,46397,170431,50964,267792
2021-03-20,La Libertad,9107,35171,6448,50726,46567,170482,52108,269157
2021-03-21,La Libertad,9144,35206,6580,50930,46698,170509,52903,270110
2021-03-22,La Libertad,9205,35232,6821,51258,47081,170768,54417,272266
2021-03-23,La Libertad,9289,35250,7075,51614,47269,170803,55805,273877
2021-01-05,Lambayeque,4860,28696,1,33557,18845,136365,2,155210
2021-01-06,Lambayeque,4903,28700,3,33606,18937,136365,6,155302
2021-01-07,Lambayeque,4950,28723,16,33689,19031,136365,32,155396
2021-01-08,Lambayeque,5005,28730,28,33763,19282,136365,56,155647
2021-01-09,Lambayeque,5070,28740,34,33844,19369,136365,68,155734
2021-01-10,Lambayeque,5121,28742,34,33897,19639,136365,68,156004
2021-01-11,Lambayeque,5123,28759,52,33934,19644,136365,104,156009
2021-01-12,Lambayeque,5147,28770,57,33974,19745,136365,188,156298
2021-01-13,Lambayeque,5194,28802,64,34060,19846,136558,371,156775
2021-01-14,Lambayeque,5259,28816,135,34210,19896,136958,791,157645
2021-01-15,Lambayeque,5338,28836,143,34317,20164,137296,864,158324
2021-01-16,Lambayeque,5429,28938,149,34516,20315,137942,922,159179
2021-01-17,Lambayeque,5429,28973,154,34556,20315,138059,939,159313
2021-01-18,Lambayeque,5429,28987,162,34578,20444,138383,981,159808
2021-01-19,Lambayeque,5444,29038,163,34645,20568,138828,1023,160419
2021-01-20,Lambayeque,5471,29082,177,34730,20632,139303,1099,161034
2021-01-21,Lambayeque,5521,29129,186,34836,20819,139866,1215,161900
2021-01-22,Lambayeque,5536,29154,190,34880,20876,140236,1291,162403
2021-01-23,Lambayeque,5628,29185,198,35011,21291,140386,1303,162980
2021-01-24,Lambayeque,5671,29199,200,35070,21353,140490,1343,163186
2021-01-25,Lambayeque,5743,29225,202,35170,21522,140594,1421,163537
2021-01-26,Lambayeque,5793,29282,211,35286,21691,140693,1566,163950
2021-01-27,Lambayeque,5832,29319,222,35373,21860,141050,1689,164599
2021-01-28,Lambayeque,5873,29343,228,35444,21923,141418,1830,165171
2021-01-29,Lambayeque,5952,29357,234,35543,22337,141606,2008,165951
2021-01-30,Lambayeque,6000,29400,239,35639,22659,141833,2165,166657
2021-01-31,Lambayeque,6021,29404,241,35666,22874,141894,2187,166955
2021-02-01,Lambayeque,6035,29421,246,35702,22921,142040,2310,167271
2021-02-02,Lambayeque,6094,29481,258,35833,23014,142365,2538,167917
2021-02-03,Lambayeque,6108,29551,275,35934,23175,142834,2732,168741
2021-02-04,Lambayeque,6124,29634,291,36049,23276,143252,2883,169411
2021-02-05,Lambayeque,6238,29662,302,36202,23407,143792,3025,170224
2021-02-06,Lambayeque,6312,29721,307,36340,23789,143969,3086,170844
2021-02-07,Lambayeque,6334,29782,312,36428,23843,144580,3152,171575
2021-02-08,Lambayeque,6468,29840,318,36626,24208,144929,3263,172400
2021-02-09,Lambayeque,6568,29856,325,36749,24554,145031,3394,172979
2021-02-10,Lambayeque,6650,29936,355,36941,24708,145676,3656,174040
2021-02-11,Lambayeque,6669,29962,371,37002,24866,145943,3918,174727
2021-02-12,Lambayeque,6715,29966,380,37061,25193,146409,4083,175685
2021-02-13,Lambayeque,6730,30043,384,37157,25656,146574,4220,176450
2021-02-14,Lambayeque,6730,30060,391,37181,25740,146686,4320,176746
2021-02-15,Lambayeque,6732,30093,410,37235,25763,146940,4548,177251
2021-02-16,Lambayeque,6767,30095,426,37288,26000,147077,4813,177890
2021-02-17,Lambayeque,6772,30186,437,37395,26315,147383,5029,178727
2021-02-18,Lambayeque,6816,30219,460,37495,26407,147546,5336,179289
2021-02-19,Lambayeque,6843,30243,483,37569,26483,147833,5649,179965
2021-02-20,Lambayeque,6911,30309,510,37730,26787,148073,5883,180743
2021-02-21,Lambayeque,6913,30314,517,37744,26900,148221,5965,181086
2021-02-22,Lambayeque,6919,30339,533,37791,27045,148545,6221,181811
2021-02-23,Lambayeque,6924,30368,556,37848,27310,148895,6485,182690
2021-02-24,Lambayeque,6947,30446,586,37979,27581,149333,6727,183641
2021-02-25,Lambayeque,6947,30503,604,38054,27607,150106,6997,184710
2021-02-26,Lambayeque,6948,30541,623,38112,27636,150514,7280,185430
2021-02-27,Lambayeque,7044,30582,665,38291,28154,150956,7587,186697
2021-02-28,Lambayeque,7159,30590,671,38420,28461,151026,7645,187132
2021-03-01,Lambayeque,7175,30624,688,38487,28518,151367,7942,187827
2021-03-02,Lambayeque,7175,30665,718,38558,28625,151659,8384,188668
2021-03-03,Lambayeque,7175,30732,746,38653,28625,152210,8741,189576
2021-03-04,Lambayeque,7179,30774,769,38722,28732,152547,9106,190385
2021-03-05,Lambayeque,7259,30788,792,38839,29035,152989,9458,191482
2021-03-06,Lambayeque,7305,30808,837,38950,29215,153223,9810,192248
2021-03-07,Lambayeque,7390,30809,845,39044,29418,153281,9901,192600
2021-03-08,Lambayeque,7429,30818,883,39130,29515,153447,10198,193160
2021-03-09,Lambayeque,7429,30858,926,39213,29572,153726,10657,193955
2021-03-10,Lambayeque,7474,30897,981,39352,29716,154152,11166,195034
2021-03-11,Lambayeque,7485,30940,1009,39434,29875,154523,11528,195926
2021-03-12,Lambayeque,7524,30964,1031,39519,30191,154613,11751,196555
2021-03-13,Lambayeque,7524,30978,1058,39560,30191,155017,12138,197346
2021-03-14,Lambayeque,7633,30983,1069,39685,30312,155056,12291,197659
2021-03-15,Lambayeque,7644,31003,1105,39752,30318,155155,12681,198154
2021-03-16,Lambayeque,7695,31029,1174,39898,30509,155313,13298,199120
2021-03-17,Lambayeque,7695,31088,1221,40004,30568,155694,13793,200055
2021-03-18,Lambayeque,7736,31111,1267,40114,30596,155861,14364,200821
2021-03-19,Lambayeque,7739,31126,1311,40176,30597,156247,14707,201551
2021-03-20,Lambayeque,7741,31145,1354,40240,30797,156475,15020,202292
2021-03-21,Lambayeque,7948,31189,1378,40515,31163,157045,15163,203371
2021-03-22,Lambayeque,7995,31248,1463,40706,31272,158920,15726,205918
2021-03-23,Lambayeque,8125,31285,1561,40971,31522,159280,16370,207172
2021-01-05,Lima Metropolitana,153865,267172,114,421151,1076323,1413127,228,2489450
2021-01-06,Lima Metropolitana,154534,267276,227,422037,1081098,1415609,454,2496707
2021-01-07,Lima Metropolitana,155276,267510,443,423229,1086130,1418085,886,2504215
2021-01-08,Lima Metropolitana,156502,267620,584,424706,1095232,1420563,1168,2515795
2021-01-09,Lima Metropolitana,157581,267875,687,426143,1101761,1423046,1374,2524807
2021-01-10,Lima Metropolitana,158558,267958,751,427267,1108424,1425529,1502,2533953
2021-01-11,Lima Metropolitana,159723,268187,921,428831,1116951,1428011,1842,2544962
2021-01-12,Lima Metropolitana,161023,268260,1129,430412,1125705,1430493,11732,2567930
2021-01-13,Lima Metropolitana,162236,268879,1383,432498,1133131,1433533,11499,2578163
2021-01-14,Lima Metropolitana,163264,269201,3233,435698,1137933,1436004,25004,2598941
2021-01-15,Lima Metropolitana,164418,269607,3465,437490,1145551,1438874,27270,2611695
2021-01-16,Lima Metropolitana,165605,269960,3715,439280,1156185,1441578,29607,2627370
2021-01-17,Lima Metropolitana,167099,270248,3878,441225,1167601,1442956,31246,2641803
2021-01-18,Lima Metropolitana,168844,270619,4129,443592,1177314,1445590,33182,2656086
2021-01-19,Lima Metropolitana,170722,270969,4581,446272,1189301,1447541,35119,2671961
2021-01-20,Lima Metropolitana,171651,271456,5028,448135,1197539,1451346,35802,2684687
2021-01-21,Lima Metropolitana,173045,271917,5540,450502,1209681,1454838,40051,2704570
2021-01-22,Lima Metropolitana,175043,272343,6042,453428,1221275,1457675,40858,2719808
2021-01-23,Lima Metropolitana,176996,272655,6399,456050,1234109,1459831,44031,2737971
2021-01-24,Lima Metropolitana,178741,272827,6609,458177,1241034,1460896,46281,2748211
2021-01-25,Lima Metropolitana,180197,273121,7096,460414,1253904,1461962,49375,2765241
2021-01-26,Lima Metropolitana,181923,273685,7738,463346,1266774,1464154,53583,2784511
2021-01-27,Lima Metropolitana,183187,274072,8506,465765,1279644,1466327,58635,2804606
2021-01-28,Lima Metropolitana,184847,274517,9168,468532,1289944,1468934,65122,2824000
2021-01-29,Lima Metropolitana,187265,274917,9935,472117,1312565,1471543,71563,2855671
2021-01-30,Lima Metropolitana,188352,275250,10597,474199,1319351,1473676,76865,2869892
2021-01-31,Lima Metropolitana,190460,275414,10872,476746,1328560,1474423,77321,2880304
2021-02-01,Lima Metropolitana,192810,275789,11839,480438,1340768,1477113,84181,2902062
2021-02-02,Lima Metropolitana,195607,276254,12848,484709,1354254,1479617,91800,2925671
2021-02-03,Lima Metropolitana,196983,276796,13926,487705,1366786,1482496,99595,2948877
2021-02-04,Lima Metropolitana,199470,277244,15076,491790,1378033,1484409,107368,2969810
2021-02-05,Lima Metropolitana,202445,277381,16185,496011,1392075,1486495,115374,2993944
2021-02-06,Lima Metropolitana,204693,277930,16602,499225,1401787,1487024,119104,3007915
2021-02-07,Lima Metropolitana,206585,277989,17177,501751,1411016,1488144,123977,3023137
2021-02-08,Lima Metropolitana,208295,278268,17916,504479,1418131,1489481,130480,3038092
2021-02-09,Lima Metropolitana,209906,278612,19086,507604,1428437,1490937,139779,3059153
2021-02-10,Lima Metropolitana,211687,279258,20819,511764,1439061,1493932,155248,3088241
2021-02-11,Lima Metropolitana,213510,279907,22503,515920,1449405,1496147,171929,3117481
2021-02-12,Lima Metropolitana,215126,280037,24064,519227,1457824,1498191,187757,3143772
2021-02-13,Lima Metropolitana,216955,280883,25355,523193,1468452,1499760,200842,3169054
2021-02-14,Lima Metropolitana,218197,281059,25854,525110,1475723,1500632,205943,3182298
2021-02-15,Lima Metropolitana,219599,281474,27190,528263,1482490,1502364,219493,3204347
2021-02-16,Lima Metropolitana,221902,281606,29035,532543,1495236,1504596,235465,3235297
2021-02-17,Lima Metropolitana,224479,282473,30654,537606,1507941,1506944,250169,3265054
2021-02-18,Lima Metropolitana,226628,282867,32218,541713,1519187,1508893,264753,3292833
2021-02-19,Lima Metropolitana,228350,283005,33760,545115,1528898,1510947,279643,3319488
2021-02-20,Lima Metropolitana,230058,283638,34931,548627,1537816,1512219,291395,3341430
2021-02-21,Lima Metropolitana,231187,283806,35489,550482,1542931,1513218,296255,3352404
2021-02-22,Lima Metropolitana,232953,284232,36928,554113,1554533,1515888,309402,3379823
2021-02-23,Lima Metropolitana,234380,284678,38323,557381,1562492,1517234,323664,3403390
2021-02-24,Lima Metropolitana,235981,285112,39907,561000,1571532,1518914,338966,3429412
2021-02-25,Lima Metropolitana,237946,285496,41303,564745,1582763,1520502,354049,3457314
2021-02-26,Lima Metropolitana,240040,285859,42655,568554,1592530,1521852,368147,3482529
2021-02-27,Lima Metropolitana,241589,286145,43835,571569,1600440,1523057,380390,3503887
2021-02-28,Lima Metropolitana,242686,286289,44273,573248,1605368,1523955,385055,3514378
2021-03-01,Lima Metropolitana,243707,286586,45542,575835,1612619,1525601,398543,3536763
2021-03-02,Lima Metropolitana,245175,286967,46964,579106,1624018,1526888,413604,3564510
2021-03-03,Lima Metropolitana,245599,287386,48447,581432,1634048,1528810,430348,3593206
2021-03-04,Lima Metropolitana,247874,287752,50046,585672,1645535,1530295,446816,3622646
2021-03-05,Lima Metropolitana,249560,288076,51287,588923,1656150,1531783,463530,3651463
2021-03-06,Lima Metropolitana,251096,288365,52492,591953,1665865,1532881,478591,3677337
2021-03-07,Lima Metropolitana,252456,288440,52845,593741,1673517,1533331,483444,3690292
2021-03-08,Lima Metropolitana,253509,288674,54239,596422,1681989,1534769,498159,3714917
2021-03-09,Lima Metropolitana,254753,289020,56015,599788,1693029,1536283,516850,3746162
2021-03-10,Lima Metropolitana,255941,289415,57674,603030,1700858,1537822,535415,3774095
2021-03-11,Lima Metropolitana,257898,289803,59663,607364,1712948,1539296,555864,3808108
2021-03-12,Lima Metropolitana,258863,290160,60927,609950,1724909,1541156,572980,3839045
2021-03-13,Lima Metropolitana,258863,290485,62491,611839,1724909,1543015,593317,3861241
2021-03-14,Lima Metropolitana,261715,290665,63551,615931,1738439,1544296,606462,3889197
2021-03-15,Lima Metropolitana,263898,290943,65542,620383,1751586,1546495,627856,3925937
2021-03-16,Lima Metropolitana,265382,291241,67577,624200,1765107,1547785,648072,3960964
2021-03-17,Lima Metropolitana,266994,291576,69452,628022,1777362,1549395,666692,3993449
2021-03-18,Lima Metropolitana,268354,291857,71325,631536,1787287,1550593,685326,4023206
2021-03-19,Lima Metropolitana,270313,292275,73295,635883,1799800,1552434,704499,4056733
2021-03-20,Lima Metropolitana,270622,292535,74988,638145,1808323,1553246,721667,4083236
2021-03-21,Lima Metropolitana,273264,292676,75661,641601,1820751,1554168,729000,4103919
2021-03-22,Lima Metropolitana,275100,292973,77490,645563,1831694,1555559,746693,4133946
2021-03-23,Lima Metropolitana,278088,293321,79687,651096,1849957,1557218,765652,4172827
2021-01-06,Lima Region,6973,25914,3,32890,70165,91876,5,162041
2021-01-07,Lima Region,7033,25922,10,32965,70492,92036,15,162528
2021-01-08,Lima Region,7059,25933,18,33010,71083,92197,25,163280
2021-01-09,Lima Region,7065,25944,28,33037,71507,92358,45,163865
2021-01-10,Lima Region,7167,25947,42,33156,71939,92520,84,164459
2021-01-11,Lima Region,7204,25965,44,33213,72492,92681,300,165173
2021-01-12,Lima Region,7229,26022,59,33310,73061,92842,720,166664
2021-01-13,Lima Region,7233,26090,69,33392,73542,93039,746,167327
2021-01-14,Lima Region,7234,26131,160,33525,73854,93199,1623,168676
2021-01-15,Lima Region,7332,26163,170,33665,74349,93386,1770,169505
2021-01-16,Lima Region,7422,26186,181,33789,75039,93561,1921,170521
2021-01-17,Lima Region,7465,26206,187,33858,75780,93651,2028,171459
2021-01-18,Lima Region,7562,26229,207,33998,76410,93822,2154,172386
2021-01-19,Lima Region,7607,26255,243,34105,77188,93948,2279,173415
2021-01-20,Lima Region,7614,26294,264,34172,77723,94195,2324,174242
2021-01-21,Lima Region,7616,26364,301,34281,78511,94422,2599,175532
2021-01-22,Lima Region,7712,26428,338,34478,79263,94606,2652,176521
2021-01-23,Lima Region,7734,26460,369,34563,80096,94746,2858,177700
2021-01-24,Lima Region,7894,26484,389,34767,80546,94815,3004,178365
2021-01-25,Lima Region,7909,26484,411,34804,81381,94884,3204,179469
2021-01-26,Lima Region,7939,26589,483,35011,82216,95026,3478,180720
2021-01-27,Lima Region,7986,26648,554,35188,83051,95167,3805,182023
2021-01-28,Lima Region,8022,26715,596,35333,83720,95337,4226,183283
2021-01-29,Lima Region,8037,26751,691,35479,85188,95506,4645,185339
2021-01-30,Lima Region,8130,26803,732,35665,85629,95644,4989,186262
2021-01-31,Lima Region,8200,26829,762,35791,86226,95693,5018,186937
2021-02-01,Lima Region,8272,26857,869,35998,87018,95868,5463,188349
2021-02-02,Lima Region,8302,26913,987,36202,87894,96030,5958,189882
2021-02-03,Lima Region,8478,26988,1150,36616,88707,96217,6464,191388
2021-02-04,Lima Region,8534,27036,1320,36890,89437,96341,6968,192746
2021-02-05,Lima Region,8619,27050,1479,37148,90348,96476,7488,194312
2021-02-06,Lima Region,8735,27050,1536,37321,90979,96511,7730,195220
2021-02-07,Lima Region,8823,27170,1617,37610,91578,96583,8046,196207
2021-02-08,Lima Region,8853,27194,1693,37740,92040,96670,8468,197178
2021-02-09,Lima Region,8938,27261,1889,38088,92708,96765,9072,198545
2021-02-10,Lima Region,8956,27303,2098,38357,93398,96959,10076,200433
2021-02-11,Lima Region,8976,27378,2264,38618,94069,97103,11159,202331
2021-02-12,Lima Region,9051,27389,2432,38872,94616,97236,12186,204038
2021-02-13,Lima Region,9089,27449,2581,39119,95306,97337,13035,205678
2021-02-14,Lima Region,9167,27449,2627,39243,95777,97394,13366,206537
2021-02-15,Lima Region,9184,27485,2817,39486,96217,97506,14245,207968
2021-02-16,Lima Region,9219,27497,2971,39687,97044,97651,15282,209977
2021-02-17,Lima Region,9259,27601,3163,40023,97868,97804,16236,211908
2021-02-18,Lima Region,9323,27656,3315,40294,98598,97930,17183,213711
2021-02-19,Lima Region,9332,27676,3511,40519,99229,98063,18149,215441
2021-02-20,Lima Region,9393,27729,3642,40764,99807,98146,18912,216865
2021-02-21,Lima Region,9401,27744,3732,40877,100139,98211,19228,217578
2021-02-22,Lima Region,9407,27780,3862,41049,100892,98384,20081,219357
2021-02-23,Lima Region,9472,27823,4094,41389,101409,98471,21006,220886
2021-02-24,Lima Region,9480,27869,4272,41621,101996,98580,22000,222576
2021-02-25,Lima Region,9559,27917,4491,41967,102725,98684,22979,224388
2021-02-26,Lima Region,9581,27952,4635,42168,103358,98771,23893,226022
2021-02-27,Lima Region,9599,27974,4810,42383,103872,98849,24688,227409
2021-02-28,Lima Region,9641,27980,4868,42489,104192,98908,24991,228091
2021-03-01,Lima Region,9647,28006,5029,42682,104662,99015,25866,229543
2021-03-02,Lima Region,9676,28052,5211,42939,105402,99098,26844,231344
2021-03-03,Lima Region,9682,28081,5392,43155,106053,99223,27930,233206
2021-03-04,Lima Region,9709,28133,5614,43456,106798,99319,28999,235116
2021-03-05,Lima Region,9782,28170,5828,43780,107487,99416,30084,236987
2021-03-06,Lima Region,9788,28213,6008,44009,108118,99487,31062,238667
2021-03-07,Lima Region,9851,28224,6094,44169,108615,99516,31376,239507
2021-03-08,Lima Region,9853,28247,6258,44358,109164,99610,32331,241105
2021-03-09,Lima Region,9915,28294,6466,44675,109881,99708,33545,243134
2021-03-10,Lima Region,9925,28324,6743,44992,110389,99808,34749,244946
2021-03-11,Lima Region,9953,28373,6978,45304,111174,99903,36077,247154
2021-03-12,Lima Region,9985,28415,7140,45540,111950,100024,37188,249162
2021-03-13,Lima Region,9985,28460,7368,45813,111950,100145,38507,250602
2021-03-14,Lima Region,10022,28469,7449,45940,112828,100228,39361,252417
2021-03-15,Lima Region,10089,28503,7662,46254,113681,100371,40749,254801
2021-03-16,Lima Region,10164,28553,7968,46685,114559,100454,42061,257074
2021-03-17,Lima Region,10176,28580,8216,46972,115354,100559,43270,259183
2021-03-18,Lima Region,10233,28612,8420,47265,115999,100637,44479,261115
2021-03-19,Lima Region,10284,28666,8719,47669,116811,100756,45723,263290
2021-03-20,Lima Region,10284,28711,8993,47988,117364,100809,46838,265011
2021-03-21,Lima Region,10346,28723,9133,48202,118170,100868,47314,266352
2021-03-22,Lima Region,10346,28748,9441,48535,118881,100959,48462,268302
2021-03-23,Lima Region,10348,28789,9805,48942,120066,101067,49692,270825
2021-01-07,Loreto,3331,23112,6,26449,10734,63441,12,74175
2021-01-08,Loreto,3345,23114,10,26469,10799,63583,20,74382
2021-01-09,Loreto,3350,23116,10,26476,10835,63722,20,74557
2021-01-10,Loreto,3358,23119,10,26487,10900,63864,20,74764
2021-01-11,Loreto,3372,23144,17,26533,10930,63999,34,74929
2021-01-12,Loreto,3378,23146,19,26543,10964,64136,22,75122
2021-01-13,Loreto,3396,23168,20,26584,11010,64231,52,75293
2021-01-14,Loreto,3405,23180,55,26640,11058,64412,111,75581
2021-01-15,Loreto,3406,23208,63,26677,11081,64688,154,75923
2021-01-16,Loreto,3418,23226,69,26713,11112,64806,161,76079
2021-01-17,Loreto,3444,23228,69,26741,11235,64976,165,76376
2021-01-18,Loreto,3450,23235,70,26755,11249,65099,183,76531
2021-01-19,Loreto,3451,23252,81,26784,11254,65261,201,76716
2021-01-20,Loreto,3476,23275,90,26841,11373,65561,221,77155
2021-01-21,Loreto,3510,23304,100,26914,11491,65801,279,77571
2021-01-22,Loreto,3522,23326,112,26960,11538,66022,297,77857
2021-01-23,Loreto,3522,23334,117,26973,11548,66097,333,77978
2021-01-24,Loreto,3522,23337,127,26986,11548,66117,370,78035
2021-01-25,Loreto,3522,23353,133,27008,11548,66137,398,78083
2021-01-26,Loreto,3534,23398,146,27078,11548,66377,440,78365
2021-01-27,Loreto,3557,23415,148,27120,11548,66570,457,78575
2021-01-28,Loreto,3572,23438,183,27193,11618,66891,501,79010
2021-01-29,Loreto,3623,23460,233,27316,11592,67174,690,79456
2021-01-30,Loreto,3624,23480,254,27358,11598,67313,720,79631
2021-01-31,Loreto,3624,23512,273,27409,11598,67438,796,79832
2021-02-01,Loreto,3675,23536,340,27551,11751,67616,1005,80372
2021-02-02,Loreto,3687,23577,385,27649,11815,68123,1208,81146
2021-02-03,Loreto,3687,23609,434,27730,11997,68637,1479,82113
2021-02-04,Loreto,3695,23629,473,27797,12034,69093,1723,82850
2021-02-05,Loreto,3725,23631,496,27852,12171,69341,1937,83449
2021-02-06,Loreto,3765,23654,502,27921,12291,69369,2003,83663
2021-02-07,Loreto,3766,23666,506,27938,12293,69474,2090,83857
2021-02-08,Loreto,3826,23679,516,28021,12491,69701,2175,84367
2021-02-09,Loreto,3826,23695,540,28061,12499,69882,2341,84722
2021-02-10,Loreto,3869,23733,605,28207,12633,70326,2743,85702
2021-02-11,Loreto,4005,23760,676,28441,13024,70617,3299,86940
2021-02-12,Loreto,4005,23763,756,28524,13026,70958,3724,87708
2021-02-13,Loreto,4161,23812,811,28784,13457,71133,4031,88621
2021-02-14,Loreto,4161,23829,840,28830,13457,71280,4164,88901
2021-02-15,Loreto,4238,23852,917,29007,13629,71498,4522,89649
2021-02-16,Loreto,4259,23862,989,29110,13681,71872,4869,90422
2021-02-17,Loreto,4327,23924,1091,29342,13795,72209,5287,91291
2021-02-18,Loreto,4411,23956,1202,29569,14028,72492,5773,92293
2021-02-19,Loreto,4469,23963,1304,29736,14147,72774,6286,93207
2021-02-20,Loreto,4474,23998,1380,29852,14163,72903,6705,93771
2021-02-21,Loreto,4474,24010,1431,29915,14164,72982,7034,94180
2021-02-22,Loreto,4621,24042,1494,30157,14491,73268,7492,95251
2021-02-23,Loreto,4781,24067,1597,30445,14863,73436,8091,96390
2021-02-24,Loreto,5121,24098,1715,30934,15721,73656,8801,98178
2021-02-25,Loreto,5484,24156,1817,31457,15978,73895,9501,99374
2021-02-26,Loreto,5886,24204,1872,31962,16905,74131,10189,101225
2021-02-27,Loreto,5981,24223,1902,32106,17189,74294,10415,101898
2021-02-28,Loreto,6021,24227,1927,32175,17317,74318,10797,102432
2021-03-01,Loreto,6048,24268,1982,32298,17446,74654,11229,103329
2021-03-02,Loreto,6051,24323,2032,32406,17457,75090,11883,104430
2021-03-03,Loreto,6060,24376,2075,32511,17540,75467,12207,105214
2021-03-04,Loreto,6152,24410,2153,32715,17551,75772,12781,106104
2021-03-05,Loreto,6153,24454,2228,32835,17553,76113,13178,106844
2021-03-06,Loreto,6154,24467,2261,32882,17553,76584,13480,107617
2021-03-07,Loreto,6222,24473,2273,32968,17688,76645,13636,107969
2021-03-08,Loreto,6235,24509,2345,33089,17719,77130,14053,108902
2021-03-09,Loreto,6294,24553,2405,33252,17889,77755,14492,110136
2021-03-10,Loreto,6316,24610,2444,33370,17974,78812,14855,111641
2021-03-11,Loreto,6316,24661,2538,33515,17977,79790,15399,113166
2021-03-12,Loreto,6339,24727,2628,33694,18367,81589,16012,115968
2021-03-13,Loreto,6339,24750,2655,33744,18367,81895,16456,116718
2021-03-14,Loreto,6439,24757,2670,33866,18381,81941,16589,116911
2021-03-15,Loreto,6454,24791,2771,34016,18474,82474,17269,118217
2021-03-16,Loreto,6460,24860,2846,34166,18493,83304,17889,119686
2021-03-17,Loreto,6460,24897,2951,34308,18493,83987,18512,120992
2021-03-18,Loreto,6512,24948,3058,34518,18724,84757,19226,122707
2021-03-19,Loreto,6512,24988,3156,34656,18724,85329,19743,123796
2021-03-20,Loreto,6512,25018,3223,34753,18724,85806,20289,124819
2021-03-21,Loreto,6512,25033,3253,34798,18724,86077,20460,125261
2021-03-22,Loreto,6512,25097,3322,34931,18725,86502,20806,126033
2021-03-23,Loreto,6512,25150,3438,35100,18725,87202,21398,127325
2021-01-22,MADRE DE DIOS,923,8762,1,9686,3839,42823,77,46739
2021-01-23,MADRE DE DIOS,925,8771,2,9698,3871,42882,78,46831
2021-01-24,MADRE DE DIOS,925,8775,2,9702,3871,42915,78,46864
2021-01-25,MADRE DE DIOS,935,8782,2,9719,3957,42948,81,46986
2021-01-26,MADRE DE DIOS,936,8791,6,9733,4043,43018,82,47143
2021-01-27,MADRE DE DIOS,936,8806,6,9748,4129,43164,85,47378
2021-01-28,MADRE DE DIOS,940,8817,7,9764,4144,43242,94,47480
2021-01-29,MADRE DE DIOS,941,8817,7,9765,4389,43315,115,47819
2021-01-30,MADRE DE DIOS,943,8820,7,9770,4418,43347,150,47915
2021-01-31,MADRE DE DIOS,943,8821,8,9772,4418,43466,173,48057
2021-02-01,MADRE DE DIOS,944,8825,8,9777,4432,43800,193,48425
2021-02-02,MADRE DE DIOS,944,8837,10,9791,4433,44051,220,48704
2021-02-03,MADRE DE DIOS,952,8840,10,9802,4329,44258,244,48831
2021-02-04,MADRE DE DIOS,961,8847,13,9821,4374,44439,272,49085
2021-02-05,MADRE DE DIOS,963,8848,14,9825,4388,44736,290,49414
2021-02-06,MADRE DE DIOS,969,8849,14,9832,4419,44781,298,49498
2021-02-07,MADRE DE DIOS,969,8854,14,9837,4419,44902,304,49625
2021-02-08,MADRE DE DIOS,970,8863,15,9848,4433,45060,322,49815
2021-02-09,MADRE DE DIOS,975,8871,15,9861,4463,45225,346,50034
2021-02-10,MADRE DE DIOS,981,8881,16,9878,4503,45401,384,50288
2021-02-11,MADRE DE DIOS,989,8889,18,9896,4523,45568,413,50504
2021-02-12,MADRE DE DIOS,1001,8891,21,9913,4525,45695,461,50681
2021-02-13,MADRE DE DIOS,1006,8900,23,9929,4540,45789,498,50827
2021-02-14,MADRE DE DIOS,1006,8903,23,9932,4540,45812,505,50857
2021-02-15,MADRE DE DIOS,1010,8912,24,9946,4553,46017,601,51171
2021-02-16,MADRE DE DIOS,1017,8916,25,9958,4568,46198,649,51415
2021-02-17,MADRE DE DIOS,1030,8932,27,9989,4599,46346,675,51620
2021-02-18,MADRE DE DIOS,1032,8936,28,9996,4606,46450,709,51765
2021-02-19,MADRE DE DIOS,1036,8943,30,10009,4625,46583,756,51964
2021-02-20,MADRE DE DIOS,1042,8958,32,10032,4668,46685,804,52157
2021-02-21,MADRE DE DIOS,1042,8962,40,10044,4668,46761,846,52275
2021-02-22,MADRE DE DIOS,1046,8971,43,10060,4699,46894,897,52490
2021-02-23,MADRE DE DIOS,1070,8979,52,10101,4745,47020,960,52725
2021-02-24,MADRE DE DIOS,1088,8983,56,10127,4805,47102,1015,52922
2021-02-25,MADRE DE DIOS,1091,8987,72,10150,4820,47218,1071,53109
2021-02-26,MADRE DE DIOS,1102,8991,86,10179,4865,47310,1141,53316
2021-02-27,MADRE DE DIOS,1113,8997,96,10206,4896,47373,1218,53487
2021-02-28,MADRE DE DIOS,1113,8998,104,10215,4896,47402,1252,53550
2021-03-01,MADRE DE DIOS,1118,9004,116,10238,4912,47580,1320,53812
2021-03-02,MADRE DE DIOS,1129,9006,142,10277,4927,47679,1439,54045
2021-03-03,MADRE DE DIOS,1129,9009,153,10291,4954,47771,1519,54244
2021-03-04,MADRE DE DIOS,1156,9012,171,10339,4969,47944,1635,54548
2021-03-05,MADRE DE DIOS,1176,9016,197,10389,4969,47999,1781,54749
2021-03-06,MADRE DE DIOS,1191,9020,224,10435,4997,48071,1888,54956
2021-03-07,MADRE DE DIOS,1191,9020,245,10456,4997,48090,1959,55046
2021-03-08,MADRE DE DIOS,1191,9037,268,10496,4997,48244,2079,55320
2021-03-09,MADRE DE DIOS,1191,9041,321,10553,4998,48329,2265,55592
2021-03-10,MADRE DE DIOS,1191,9054,345,10590,5231,48463,2379,56073
2021-03-11,MADRE DE DIOS,1191,9069,375,10635,5231,48736,2524,56491
2021-03-12,MADRE DE DIOS,1191,9074,415,10680,5231,48919,2663,56813
2021-03-13,MADRE DE DIOS,1191,9077,465,10733,5231,49018,2881,57130
2021-03-14,MADRE DE DIOS,1191,9081,488,10760,5231,49070,3009,57310
2021-03-15,MADRE DE DIOS,1191,9096,534,10821,5231,49208,3160,57599
2021-03-16,MADRE DE DIOS,1191,9101,570,10862,5231,49320,3353,57904
2021-03-17,MADRE DE DIOS,1191,9111,620,10922,5231,49496,3502,58229
2021-03-18,MADRE DE DIOS,1191,9127,673,10991,5231,49628,3708,58567
2021-03-19,MADRE DE DIOS,1191,9142,730,11063,5231,49784,3927,58942
2021-03-20,MADRE DE DIOS,1191,9150,771,11112,5231,49864,4053,59148
2021-03-21,MADRE DE DIOS,1191,9155,811,11157,5231,49890,4153,59274
2021-03-22,MADRE DE DIOS,1191,9165,848,11204,5231,50022,4278,59531
2021-03-23,MADRE DE DIOS,1191,9180,894,11265,5231,50097,4421,59749
2021-01-05,MOQUEGUA,622,15599,8,16229,7439,104436,16,111875
2021-01-06,MOQUEGUA,631,15621,9,16261,7913,104436,18,112349
2021-01-07,MOQUEGUA,656,15661,18,16335,8196,104436,36,112632
2021-01-08,MOQUEGUA,670,15686,25,16381,8386,104436,50,112822
2021-01-09,MOQUEGUA,676,15710,31,16417,8427,104436,62,112863
2021-01-10,MOQUEGUA,683,15717,40,16440,9106,104436,80,113542
2021-01-11,MOQUEGUA,694,15745,48,16487,9169,104436,96,113605
2021-01-12,MOQUEGUA,726,15758,64,16548,9431,104436,271,114138
2021-01-13,MOQUEGUA,739,15830,77,16646,10029,104967,380,115376
2021-01-14,MOQUEGUA,739,15868,198,16805,10029,105326,794,116149
2021-01-15,MOQUEGUA,739,15928,218,16885,10029,105713,882,116624
2021-01-16,MOQUEGUA,754,15964,221,16939,10068,106054,977,117099
2021-01-17,MOQUEGUA,790,15977,221,16988,11129,106197,1015,118341
2021-01-18,MOQUEGUA,861,16009,223,17093,11613,106540,1076,119229
2021-01-19,MOQUEGUA,869,16044,229,17142,11663,106785,1137,119585
2021-01-20,MOQUEGUA,899,16093,244,17236,12289,107237,1304,120830
2021-01-21,MOQUEGUA,926,16121,251,17298,12589,107622,1528,121739
2021-01-22,MOQUEGUA,945,16151,262,17358,12890,107940,1677,122507
2021-01-23,MOQUEGUA,967,16188,269,17424,13073,108316,1826,123215
2021-01-24,MOQUEGUA,1001,16194,269,17464,13320,108408,1850,123578
2021-01-25,MOQUEGUA,1019,16231,273,17523,13814,108500,1970,124284
2021-01-26,MOQUEGUA,1041,16292,277,17610,14308,108813,2109,125230
2021-01-27,MOQUEGUA,1075,16330,279,17684,14802,109286,2221,126309
2021-01-28,MOQUEGUA,1150,16373,294,17817,14879,109596,2332,126807
2021-01-29,MOQUEGUA,1177,16418,297,17892,15745,110337,2491,128573
2021-01-30,MOQUEGUA,1203,16451,303,17957,16534,110761,2616,129911
2021-01-31,MOQUEGUA,1205,16462,305,17972,16628,110909,2644,130181
2021-02-01,MOQUEGUA,1281,16516,310,18107,17292,111365,2748,131405
2021-02-02,MOQUEGUA,1357,16559,324,18240,17633,111894,2981,132508
2021-02-03,MOQUEGUA,1387,16580,335,18302,17883,112294,3205,133382
2021-02-04,MOQUEGUA,1439,16614,348,18401,18072,112662,3427,134161
2021-02-05,MOQUEGUA,1439,16627,367,18433,18089,113194,3617,134900
2021-02-06,MOQUEGUA,1439,16647,375,18461,18429,113320,3681,135430
2021-02-07,MOQUEGUA,1524,16655,380,18559,18917,113422,3695,136034
2021-02-08,MOQUEGUA,1563,16669,382,18614,19466,113594,3833,136893
2021-02-09,MOQUEGUA,1587,16690,392,18669,19657,113858,4037,137552
2021-02-10,MOQUEGUA,1629,16741,403,18773,20470,114459,4294,139223
2021-02-11,MOQUEGUA,1652,16780,413,18845,20623,114796,4651,140070
2021-02-12,MOQUEGUA,1652,16794,424,18870,20624,115293,4865,140782
2021-02-13,MOQUEGUA,1728,16871,432,19031,21538,115565,4993,142096
2021-02-14,MOQUEGUA,1761,16891,433,19085,21760,115686,5026,142472
2021-02-15,MOQUEGUA,1795,16937,444,19176,21901,116214,5219,143334
2021-02-16,MOQUEGUA,1834,16947,454,19235,21979,116581,5407,143967
2021-02-17,MOQUEGUA,1865,17020,466,19351,22967,117227,5623,145817
2021-02-18,MOQUEGUA,1890,17053,472,19415,23393,117454,5832,146679
2021-02-19,MOQUEGUA,1923,17087,481,19491,24033,117969,6014,148016
2021-02-20,MOQUEGUA,1939,17138,491,19568,24342,118310,6217,148869
2021-02-21,MOQUEGUA,1956,17147,496,19599,24461,118420,6247,149128
2021-02-22,MOQUEGUA,1972,17192,505,19669,24530,118874,6515,149919
2021-02-23,MOQUEGUA,2011,17217,516,19744,25254,119038,6780,151072
2021-02-24,MOQUEGUA,2045,17248,524,19817,25576,119509,6932,152017
2021-02-25,MOQUEGUA,2060,17269,544,19873,25707,119691,7146,152544
2021-02-26,MOQUEGUA,2098,17333,558,19989,26412,120213,7303,153928
2021-02-27,MOQUEGUA,2116,17352,572,20040,26588,120378,7481,154447
2021-02-28,MOQUEGUA,2130,17360,573,20063,26707,120448,7500,154655
2021-03-01,MOQUEGUA,2137,17380,584,20101,26821,120804,7775,155400
2021-03-02,MOQUEGUA,2175,17414,591,20180,27439,121164,8153,156756
2021-03-03,MOQUEGUA,2175,17467,597,20239,27673,121652,8461,157786
2021-03-04,MOQUEGUA,2210,17488,605,20303,28291,121955,8782,159028
2021-03-05,MOQUEGUA,2249,17516,621,20386,29075,122352,9220,160647
2021-03-06,MOQUEGUA,2270,17538,631,20439,29217,122557,9393,161167
2021-03-07,MOQUEGUA,2300,17559,638,20497,29462,122787,9438,161687
2021-03-08,MOQUEGUA,2325,17576,647,20548,29631,123006,9651,162288
2021-03-09,MOQUEGUA,2362,17584,664,20610,30350,123252,10120,163722
2021-03-10,MOQUEGUA,2393,17598,677,20668,30372,123402,10474,164248
2021-03-11,MOQUEGUA,2419,17610,688,20717,30559,123571,10717,164847
2021-03-12,MOQUEGUA,2438,17614,694,20746,31202,123768,10985,165955
2021-03-13,MOQUEGUA,2438,17618,702,20758,31202,124210,11315,166727
2021-03-14,MOQUEGUA,2490,17620,708,20818,31732,124278,11403,167413
2021-03-15,MOQUEGUA,2512,17629,729,20870,31864,124558,11708,168130
2021-03-16,MOQUEGUA,2546,17634,755,20935,32455,124888,12113,169456
2021-03-17,MOQUEGUA,2576,17640,763,20979,32701,125015,12595,170311
2021-03-18,MOQUEGUA,2610,17655,778,21043,32892,125150,13021,171063
2021-03-19,MOQUEGUA,2653,17660,788,21101,33668,125248,13464,172380
2021-03-20,MOQUEGUA,2653,17663,814,21130,34050,125331,13718,173099
2021-03-21,MOQUEGUA,2710,17669,829,21208,34264,125370,13835,173469
2021-03-22,MOQUEGUA,2739,17673,845,21257,34466,125434,14143,174043
2021-03-23,MOQUEGUA,2781,17676,871,21328,34783,125517,14572,174872
2021-01-05,PASCO,393,6292,2,6687,3291,45906,4,49197
2021-01-06,PASCO,393,6303,2,6698,3338,45906,4,49244
2021-01-07,PASCO,393,6335,9,6737,3385,45989,18,49374
2021-01-08,PASCO,396,6349,13,6758,3437,46071,26,49508
2021-01-09,PASCO,429,6356,18,6803,3539,46154,36,49693
2021-01-10,PASCO,433,6360,18,6811,3569,46154,36,49723
2021-01-11,PASCO,434,6385,21,6840,3572,46237,42,49809
2021-01-12,PASCO,458,6394,27,6879,3667,46237,379,50283
2021-01-13,PASCO,458,6445,31,6934,3691,46315,780,50786
2021-01-14,PASCO,458,6484,63,7005,3702,46457,1900,52059
2021-01-15,PASCO,492,6519,70,7081,3808,46586,2094,52488
2021-01-16,PASCO,507,6556,77,7140,3878,46827,2717,53422
2021-01-17,PASCO,507,6573,79,7159,3879,46952,2936,53767
2021-01-18,PASCO,507,6587,82,7176,3924,47054,3003,53981
2021-01-19,PASCO,514,6626,83,7223,3957,47225,3070,54252
2021-01-20,PASCO,526,6664,93,7283,4002,47449,3546,54997
2021-01-21,PASCO,526,6697,104,7327,4016,47615,3828,55459
2021-01-22,PASCO,529,6739,127,7395,4053,47840,3867,55760
2021-01-23,PASCO,540,6767,144,7451,4107,47991,4317,56415
2021-01-24,PASCO,544,6787,152,7483,4113,48108,4898,57119
2021-01-25,PASCO,544,6815,158,7517,4128,48225,5283,57636
2021-01-26,PASCO,546,6870,173,7589,4143,48336,5672,58151
2021-01-27,PASCO,546,6906,190,7642,4158,48572,5696,58426
2021-01-28,PASCO,548,6956,202,7706,4160,48764,6272,59196
2021-01-29,PASCO,553,7014,219,7786,4217,48969,6618,59804
2021-01-30,PASCO,553,7061,255,7869,4218,49196,6671,60085
2021-01-31,PASCO,571,7091,264,7926,4299,49317,6761,60377
2021-02-01,PASCO,577,7130,283,7990,4321,49492,6946,60759
2021-02-02,PASCO,578,7169,299,8046,4332,49628,7215,61175
2021-02-03,PASCO,578,7226,329,8133,4398,49831,7586,61815
2021-02-04,PASCO,578,7352,349,8279,4415,50188,8126,62729
2021-02-05,PASCO,580,7362,380,8322,4432,50750,8633,63815
2021-02-06,PASCO,585,7419,400,8404,4434,50947,8905,64286
2021-02-07,PASCO,591,7432,408,8431,4469,51205,9344,65018
2021-02-08,PASCO,591,7454,432,8477,4480,51310,9833,65623
2021-02-09,PASCO,591,7471,460,8522,4480,51607,10187,66274
2021-02-10,PASCO,591,7507,482,8580,4495,51803,10725,67023
2021-02-11,PASCO,594,7561,524,8679,4518,51993,11217,67728
2021-02-12,PASCO,597,7569,540,8706,4551,52141,11814,68506
2021-02-13,PASCO,597,7615,563,8775,4551,52283,12150,68984
2021-02-14,PASCO,600,7637,586,8823,4568,52390,12307,69265
2021-02-15,PASCO,601,7671,603,8875,4568,52527,12535,69630
2021-02-16,PASCO,601,7678,636,8915,4585,52730,12924,70239
2021-02-17,PASCO,606,7724,674,9004,4604,52845,13223,70672
2021-02-18,PASCO,607,7744,694,9045,4605,53089,13657,71351
2021-02-19,PASCO,607,7758,713,9078,4623,53178,13974,71775
2021-02-20,PASCO,607,7775,744,9126,4623,53291,14229,72143
2021-02-21,PASCO,615,7789,765,9169,4656,53350,14539,72545
2021-02-22,PASCO,615,7810,784,9209,4656,53471,14987,73114
2021-02-23,PASCO,615,7828,817,9260,4685,53656,15368,73709
2021-02-24,PASCO,619,7875,837,9331,4697,53808,15623,74128
2021-02-25,PASCO,619,7895,852,9366,4721,53995,15865,74581
2021-02-26,PASCO,619,7903,862,9384,4757,54090,16131,74978
2021-02-27,PASCO,619,7918,886,9423,4757,54178,16495,75430
2021-02-28,PASCO,621,7930,892,9443,4781,54238,16704,75723
2021-03-01,PASCO,621,7943,904,9468,4797,54339,17023,76159
2021-03-02,PASCO,621,7971,924,9516,4797,54597,17691,77085
2021-03-03,PASCO,621,7995,940,9556,4826,54711,18262,77799
2021-03-04,PASCO,621,8016,963,9600,4826,54843,18578,78247
2021-03-05,PASCO,625,8057,985,9667,4881,55004,18816,78701
2021-03-06,PASCO,626,8083,998,9707,4883,55228,19616,79727
2021-03-07,PASCO,636,8104,1026,9766,4910,55372,20257,80539
2021-03-08,PASCO,636,8127,1054,9817,4929,55509,20860,81298
2021-03-09,PASCO,636,8165,1108,9909,4929,55623,21412,81964
2021-03-10,PASCO,636,8185,1128,9949,5005,55725,22134,82864
2021-03-11,PASCO,649,8202,1175,10026,5032,55891,23194,84117
2021-03-12,PASCO,649,8216,1190,10055,5066,56039,23993,85098
2021-03-13,PASCO,649,8228,1210,10087,5066,56401,25358,86825
2021-03-14,PASCO,654,8238,1225,10117,5085,56435,25830,87350
2021-03-15,PASCO,654,8247,1263,10164,5085,56518,26496,88099
2021-03-16,PASCO,654,8257,1293,10204,5107,56640,27471,89218
2021-03-17,PASCO,654,8278,1322,10254,5107,56709,28113,89929
2021-03-18,PASCO,654,8298,1337,10289,5107,56839,28870,90816
2021-03-19,PASCO,654,8320,1359,10333,5121,57192,29258,91571
2021-03-20,PASCO,654,8348,1402,10404,5121,57373,30062,92556
2021-03-21,PASCO,654,8405,1420,10479,5121,57665,30523,93309
2021-03-22,PASCO,654,8426,1447,10527,5133,58013,31104,94250
2021-03-23,PASCO,654,8450,1535,10639,5133,58186,31628,94947
2021-01-05,PIURA,2114,41023,15,43152,11587,160777,30,172364
2021-01-06,PIURA,2204,41047,31,43282,11864,161043,62,172907
2021-01-07,PIURA,2268,41090,71,43429,12104,161307,142,173411
2021-01-08,PIURA,2315,41113,101,43529,12351,161569,202,173920
2021-01-09,PIURA,2344,41139,112,43595,12519,161822,224,174341
2021-01-10,PIURA,2355,41142,114,43611,12552,161822,228,174374
2021-01-11,PIURA,2392,41184,132,43708,12682,162081,264,174763
2021-01-12,PIURA,2440,41206,149,43795,12866,162342,1500,176708
2021-01-13,PIURA,2514,41303,168,43985,13240,162543,1362,177145
2021-01-14,PIURA,2533,41364,532,44429,13357,162784,2918,179059
2021-01-15,PIURA,2581,41448,561,44590,13542,163016,3161,179719
2021-01-16,PIURA,2633,41474,588,44695,13776,163232,3421,180429
2021-01-17,PIURA,2650,41507,605,44762,13836,163392,3544,180772
2021-01-18,PIURA,2698,41558,618,44874,14041,163647,3652,181340
2021-01-19,PIURA,2703,41596,627,44926,14074,163865,3760,181699
2021-01-20,PIURA,2742,41652,652,45046,14266,164198,3967,182431
2021-01-21,PIURA,2761,41683,692,45136,14338,164672,4327,183337
2021-01-22,PIURA,2794,41732,722,45248,14512,165100,4633,184245
2021-01-23,PIURA,2803,41767,747,45317,14554,165181,4877,184612
2021-01-24,PIURA,2841,41792,792,45425,14808,165352,4943,185103
2021-01-25,PIURA,2936,41819,831,45586,15126,165523,5142,185791
2021-01-26,PIURA,2977,41883,867,45727,15444,165705,5200,186349
2021-01-27,PIURA,3032,41931,926,45889,15762,165847,5556,187165
2021-01-28,PIURA,3078,41982,987,46047,15825,166148,6026,187999
2021-01-29,PIURA,3087,42028,1048,46163,16351,166503,6457,189311
2021-01-30,PIURA,3190,42094,1078,46362,16709,166652,6864,190225
2021-01-31,PIURA,3217,42103,1095,46415,16834,166717,6966,190517
2021-02-01,PIURA,3318,42138,1133,46589,17174,166875,7343,191392
2021-02-02,PIURA,3386,42173,1184,46743,17421,167064,7884,192369
2021-02-03,PIURA,3424,42207,1226,46857,17642,167242,8325,193209
2021-02-04,PIURA,3490,42257,1294,47041,17989,167584,8906,194479
2021-02-05,PIURA,3538,42264,1351,47153,18207,167790,9558,195555
2021-02-06,PIURA,3607,42326,1368,47301,18567,167855,9800,196222
2021-02-07,PIURA,3629,42337,1375,47341,18717,167870,10022,196609
2021-02-08,PIURA,3671,42360,1410,47441,18907,167963,10504,197374
2021-02-09,PIURA,3730,42387,1476,47593,19430,168088,11152,198670
2021-02-10,PIURA,3760,42432,1574,47766,19643,168373,12503,200519
2021-02-11,PIURA,3811,42497,1640,47948,20003,168687,13523,202213
2021-02-12,PIURA,3864,42508,1731,48103,20360,169185,14481,204026
2021-02-13,PIURA,3892,42596,1782,48270,20586,169243,15098,204927
2021-02-14,PIURA,3894,42599,1804,48297,20617,169268,15219,205104
2021-02-15,PIURA,3903,42636,1864,48403,20778,169456,16076,206310
2021-02-16,PIURA,3937,42644,1935,48516,20949,169605,17029,207583
2021-02-17,PIURA,3973,42698,2031,48702,21257,169829,18258,209344
2021-02-18,PIURA,4014,42739,2116,48869,21537,170040,19519,211096
2021-02-19,PIURA,4042,42758,2190,48990,21667,170289,20585,212541
2021-02-20,PIURA,4088,42809,2288,49185,21844,170526,21535,213905
2021-02-21,PIURA,4088,42823,2313,49224,21844,170625,21912,214381
2021-02-22,PIURA,4098,42856,2403,49357,21908,170941,23198,216047
2021-02-23,PIURA,4142,42883,2474,49499,22127,171144,24192,217463
2021-02-24,PIURA,4164,42912,2571,49647,22365,171464,25098,218927
2021-02-25,PIURA,4209,42920,2638,49767,22580,171757,26232,220569
2021-02-26,PIURA,4241,42944,2725,49910,22778,172011,27120,221909
2021-02-27,PIURA,4258,42959,2809,50026,22814,172106,27785,222705
2021-02-28,PIURA,4272,42965,2824,50061,22873,172137,27919,222929
2021-03-01,PIURA,4294,42990,2903,50187,23015,172327,28738,224080
2021-03-02,PIURA,4306,43019,3005,50330,23160,172565,29652,225377
2021-03-03,PIURA,4308,43041,3154,50503,23200,172821,30598,226619
2021-03-04,PIURA,4337,43059,3293,50689,23345,173087,31604,228036
2021-03-05,PIURA,4362,43100,3425,50887,23444,173245,32561,229250
2021-03-06,PIURA,4408,43128,3557,51093,23724,173432,33484,230640
2021-03-07,PIURA,4418,43154,3622,51194,23759,173463,33794,231016
2021-03-08,PIURA,4425,43178,3749,51352,23938,173602,34597,232137
2021-03-09,PIURA,4433,43196,3967,51596,24001,173851,35728,233580
2021-03-10,PIURA,4445,43234,4186,51865,24138,174130,37130,235398
2021-03-11,PIURA,4481,43278,4370,52129,24325,174556,38353,237234
2021-03-12,PIURA,4487,43304,4520,52311,24486,174971,39261,238718
2021-03-13,PIURA,4487,43336,4673,52496,24486,175176,40562,240224
2021-03-14,PIURA,4523,43348,4752,52623,24525,175216,41059,240800
2021-03-15,PIURA,4559,43369,4951,52879,24668,175475,42678,242821
2021-03-16,PIURA,4581,43393,5210,53184,24770,175713,44162,244645
2021-03-17,PIURA,4590,43431,5475,53496,24854,176063,45579,246496
2021-03-18,PIURA,4639,43466,5693,53798,25117,176200,46945,248262
2021-03-19,PIURA,4658,43491,5919,54068,25184,176444,48370,249998
2021-03-20,PIURA,4682,43518,6214,54414,25319,176541,49540,251400
2021-03-21,PIURA,4708,43524,6347,54579,25416,176580,50191,252187
2021-03-22,PIURA,4748,43571,6585,54904,25675,176792,51484,253951
2021-03-23,PIURA,4790,43613,6927,55330,25811,176984,53038,255833
2021-01-05,PUNO,1335,18128,3,19466,6894,101736,6,108630
2021-01-06,PUNO,1349,18129,4,19482,6929,101736,8,108665
2021-01-07,PUNO,1358,18141,4,19503,6965,102079,8,109044
2021-01-08,PUNO,1358,18146,5,19509,6965,102079,10,109044
2021-01-09,PUNO,1382,18153,10,19545,7034,102079,20,109113
2021-01-10,PUNO,1382,18162,11,19555,7034,102079,22,109113
2021-01-11,PUNO,1382,18173,12,19567,7034,102079,24,109113
2021-01-12,PUNO,1382,18190,19,19591,7034,102422,302,109758
2021-01-13,PUNO,1416,18223,25,19664,7035,102650,439,110124
2021-01-14,PUNO,1456,18252,54,19762,7119,102818,905,110842
2021-01-15,PUNO,1470,18278,58,19806,7154,103019,955,111128
2021-01-16,PUNO,1490,18292,62,19844,7246,103157,995,111398
2021-01-17,PUNO,1527,18309,63,19899,7284,103452,1014,111750
2021-01-18,PUNO,1527,18321,67,19915,7284,103541,1020,111845
2021-01-19,PUNO,1527,18352,76,19955,7284,103865,1026,112175
2021-01-20,PUNO,1577,18386,82,20045,7428,104125,1082,112635
2021-01-21,PUNO,1624,18417,83,20124,7507,104500,1208,113215
2021-01-22,PUNO,1672,18452,85,20209,7610,104695,1263,113568
2021-01-23,PUNO,1733,18480,93,20306,7704,104823,1322,113849
2021-01-24,PUNO,1773,18500,95,20368,7795,104995,1365,114155
2021-01-25,PUNO,1773,18525,104,20402,7795,105167,1442,114404
2021-01-26,PUNO,1773,18575,114,20462,7795,105375,1563,114733
2021-01-27,PUNO,1866,18618,121,20605,7795,105517,1651,114963
2021-01-28,PUNO,1963,18655,134,20752,8057,105758,1741,115556
2021-01-29,PUNO,2074,18689,146,20909,7757,106048,1849,115654
2021-01-30,PUNO,2159,18728,166,21053,7985,106248,1873,116106
2021-01-31,PUNO,2159,18746,172,21077,7985,106521,1913,116419
2021-02-01,PUNO,2159,18785,179,21123,7985,106844,2000,116829
2021-02-02,PUNO,2204,18827,207,21238,8186,107068,2034,117288
2021-02-03,PUNO,2286,18867,224,21377,8764,107393,2187,118344
2021-02-04,PUNO,2335,18896,251,21482,8951,107614,2326,118891
2021-02-05,PUNO,2502,18915,285,21702,9352,107960,2525,119837
2021-02-06,PUNO,2564,18962,297,21823,9545,108087,2599,120231
2021-02-07,PUNO,2564,18996,324,21884,9545,108277,2700,120522
2021-02-08,PUNO,2581,19039,352,21972,9545,108425,2825,120795
2021-02-09,PUNO,2635,19089,388,22112,9757,108635,3072,121464
2021-02-10,PUNO,2680,19139,440,22259,9873,108863,3357,122093
2021-02-11,PUNO,2747,19174,482,22403,10144,109048,3711,122903
2021-02-12,PUNO,2792,19196,545,22533,10216,109251,4057,123524
2021-02-13,PUNO,2837,19267,579,22683,10340,109453,4304,124097
2021-02-14,PUNO,2837,19279,590,22706,10340,109540,4425,124305
2021-02-15,PUNO,2837,19298,614,22749,10341,109700,4668,124709
2021-02-16,PUNO,2868,19308,678,22854,10442,109855,5028,125325
2021-02-17,PUNO,2900,19363,720,22983,10506,110217,5510,126233
2021-02-18,PUNO,2997,19412,750,23159,10647,110440,5855,126942
2021-02-19,PUNO,3015,19435,783,23233,10775,110620,6131,127526
2021-02-20,PUNO,3043,19489,815,23347,10794,110872,6370,128036
2021-02-21,PUNO,3087,19505,843,23435,10941,111046,6515,128502
2021-02-22,PUNO,3087,19529,885,23501,10942,111308,6848,129098
2021-02-23,PUNO,3116,19540,927,23583,11088,111476,7138,129702
2021-02-24,PUNO,3144,19565,966,23675,11114,111730,7495,130339
2021-02-25,PUNO,3178,19579,1010,23767,11228,111910,7822,130960
2021-02-26,PUNO,3189,19609,1041,23839,11275,112151,8137,131563
2021-02-27,PUNO,3198,19634,1080,23912,11320,112306,8494,132120
2021-02-28,PUNO,3198,19653,1097,23948,11320,112405,8610,132335
2021-03-01,PUNO,3202,19674,1119,23995,11324,112552,8873,132749
2021-03-02,PUNO,3219,19701,1178,24098,11410,112662,9244,133316
2021-03-03,PUNO,3219,19719,1231,24169,11410,112787,9638,133835
2021-03-04,PUNO,3257,19744,1275,24276,11496,112961,9974,134431
2021-03-05,PUNO,3265,19766,1331,24362,11554,113109,10434,135097
2021-03-06,PUNO,3285,19793,1362,24440,11554,113256,10687,135497
2021-03-07,PUNO,3285,19804,1384,24473,11554,113331,10826,135711
2021-03-08,PUNO,3285,19831,1417,24533,11554,113470,11103,136127
2021-03-09,PUNO,3296,19847,1481,24624,11584,113613,11556,136753
2021-03-10,PUNO,3362,19866,1519,24747,11704,113784,12031,137519
2021-03-11,PUNO,3362,19887,1563,24812,11704,113998,12513,138215
2021-03-12,PUNO,3384,19905,1598,24887,11791,114135,12925,138851
2021-03-13,PUNO,3384,19914,1651,24949,11791,114474,13493,139758
2021-03-14,PUNO,3406,19921,1673,25000,11791,114561,13783,140135
2021-03-15,PUNO,3435,19925,1702,25062,11892,114676,14134,140702
2021-03-16,PUNO,3452,19945,1752,25149,11993,114815,14536,141344
2021-03-17,PUNO,3452,19950,1794,25196,11993,114959,15003,141955
2021-03-18,PUNO,3478,19958,1823,25259,12045,115016,15371,142432
2021-03-19,PUNO,3524,19974,1879,25377,12182,115103,15801,143086
2021-03-20,PUNO,3524,19983,1903,25410,12249,115147,16139,143535
2021-03-21,PUNO,3540,19988,1922,25450,12249,115212,16316,143777
2021-03-22,PUNO,3547,19999,1947,25493,12249,115359,16759,144367
2021-03-23,PUNO,3554,20007,1989,25550,12387,115438,17373,145198
2021-01-07,SAN MARTIN,3486,22538,1,26025,15103,90152,2,105255
2021-01-08,SAN MARTIN,3508,22540,1,26049,15175,90152,2,105327
2021-01-09,SAN MARTIN,3528,22552,1,26081,15226,90152,2,105378
2021-01-10,SAN MARTIN,3564,22561,1,26126,15353,90152,2,105505
2021-01-11,SAN MARTIN,3581,22580,2,26163,15490,90152,4,105642
2021-01-12,SAN MARTIN,3631,22589,3,26223,15652,90152,34,105838
2021-01-13,SAN MARTIN,3663,22626,3,26292,15846,90702,34,106582
2021-01-14,SAN MARTIN,3691,22649,10,26350,15963,90998,69,107030
2021-01-15,SAN MARTIN,3738,22685,10,26433,16114,91359,71,107544
2021-01-16,SAN MARTIN,3775,22712,15,26502,16283,91696,81,108060
2021-01-17,SAN MARTIN,3788,22717,16,26521,16375,91759,89,108223
2021-01-18,SAN MARTIN,3823,22745,16,26584,16548,92019,102,108669
2021-01-19,SAN MARTIN,3863,22786,18,26667,16717,92300,115,109132
2021-01-20,SAN MARTIN,3918,22815,19,26752,16924,92679,123,109726
2021-01-21,SAN MARTIN,3981,22895,20,26896,17144,93036,140,110320
2021-01-22,SAN MARTIN,4014,22945,32,26991,17290,93552,200,111042
2021-01-23,SAN MARTIN,4070,22979,38,27087,17493,93818,233,111544
2021-01-24,SAN MARTIN,4081,22987,38,27106,17555,93859,242,111656
2021-01-25,SAN MARTIN,4125,23007,41,27173,17694,93900,250,111844
2021-01-26,SAN MARTIN,4167,23058,50,27275,17833,94170,266,112269
2021-01-27,SAN MARTIN,4205,23103,59,27367,17972,94465,283,112720
2021-01-28,SAN MARTIN,4254,23150,65,27469,18182,94851,309,113342
2021-01-29,SAN MARTIN,4287,23201,70,27558,18177,95265,339,113781
2021-01-30,SAN MARTIN,4327,23223,79,27629,18378,95585,418,114381
2021-01-31,SAN MARTIN,4338,23226,88,27652,18427,95612,466,114505
2021-02-01,SAN MARTIN,4393,23252,94,27739,18665,95884,503,115052
2021-02-02,SAN MARTIN,4438,23293,105,27836,18837,96199,571,115607
2021-02-03,SAN MARTIN,4452,23340,120,27912,18842,96506,622,115970
2021-02-04,SAN MARTIN,4500,23398,131,28029,19031,96903,696,116630
2021-02-05,SAN MARTIN,4533,23407,155,28095,19145,97425,771,117341
2021-02-06,SAN MARTIN,4536,23452,163,28151,19214,97632,832,117678
2021-02-07,SAN MARTIN,4561,23460,171,28192,19359,97708,913,117980
2021-02-08,SAN MARTIN,4586,23487,183,28256,19444,97955,970,118369
2021-02-09,SAN MARTIN,4633,23521,191,28345,19607,98295,1071,118973
2021-02-10,SAN MARTIN,4683,23566,211,28460,19828,98717,1249,119794
2021-02-11,SAN MARTIN,4683,23608,235,28526,19830,99024,1442,120296
2021-02-12,SAN MARTIN,4714,23609,256,28579,19964,99348,1624,120936
2021-02-13,SAN MARTIN,4737,23665,283,28685,20114,99606,1828,121548
2021-02-14,SAN MARTIN,4737,23668,283,28688,20114,99623,1875,121612
2021-02-15,SAN MARTIN,4762,23698,309,28769,20224,100236,2009,122469
2021-02-16,SAN MARTIN,4783,23698,341,28822,20347,100624,2248,123219
2021-02-17,SAN MARTIN,4805,23770,365,28940,20417,101064,2557,124038
2021-02-18,SAN MARTIN,4843,23812,399,29054,20521,101424,2799,124744
2021-02-19,SAN MARTIN,4865,23819,439,29123,20585,101680,3114,125379
2021-02-20,SAN MARTIN,4923,23883,472,29278,20694,102024,3342,126060
2021-02-21,SAN MARTIN,4935,23887,489,29311,20717,102078,3465,126260
2021-02-22,SAN MARTIN,4959,23912,526,29397,20797,102412,3681,126890
2021-02-23,SAN MARTIN,4990,23929,562,29481,20893,102640,3928,127461
2021-02-24,SAN MARTIN,5017,23946,592,29555,20994,102876,4134,128004
2021-02-25,SAN MARTIN,5036,23963,635,29634,21056,103138,4356,128550
2021-02-26,SAN MARTIN,5051,23984,656,29691,21201,103396,4558,129155
2021-02-27,SAN MARTIN,5085,24014,677,29776,21274,103627,4793,129694
2021-02-28,SAN MARTIN,5085,24017,687,29789,21278,103669,4851,129798
2021-03-01,SAN MARTIN,5112,24041,715,29868,21348,103942,5083,130373
2021-03-02,SAN MARTIN,5148,24068,785,30001,21488,104204,5421,131113
2021-03-03,SAN MARTIN,5148,24101,843,30092,21515,104482,5669,131666
2021-03-04,SAN MARTIN,5192,24138,884,30214,21655,104826,5972,132453
2021-03-05,SAN MARTIN,5205,24157,959,30321,21710,105088,6312,133110
2021-03-06,SAN MARTIN,5234,24173,1001,30408,21784,105290,6601,133675
2021-03-07,SAN MARTIN,5234,24179,1031,30444,21784,105308,6711,133803
2021-03-08,SAN MARTIN,5272,24206,1067,30545,21901,105546,6921,134368
2021-03-09,SAN MARTIN,5292,24249,1133,30674,21966,106068,7247,135281
2021-03-10,SAN MARTIN,5322,24274,1194,30790,21999,106562,7573,136134
2021-03-11,SAN MARTIN,5326,24310,1252,30888,22017,107026,7915,136958
2021-03-12,SAN MARTIN,5345,24371,1306,31022,22130,107597,8216,137943
2021-03-13,SAN MARTIN,5345,24388,1382,31115,22130,107914,8567,138611
2021-03-14,SAN MARTIN,5377,24402,1447,31226,22213,107988,8905,139106
2021-03-15,SAN MARTIN,5398,24431,1516,31345,22303,108502,9211,140016
2021-03-16,SAN MARTIN,5434,24480,1617,31531,22433,108930,9643,141006
2021-03-17,SAN MARTIN,5462,24534,1699,31695,22514,109223,10218,141955
2021-03-18,SAN MARTIN,5464,24621,1791,31876,22525,109863,10738,143126
2021-03-19,SAN MARTIN,5499,24672,1881,32052,22652,110206,11124,143982
2021-03-20,SAN MARTIN,5499,24717,1983,32199,22697,110430,11566,144693
2021-03-21,SAN MARTIN,5499,24732,2004,32235,22697,110467,11747,144911
2021-03-22,SAN MARTIN,5526,24809,2085,32420,22813,110771,12289,145873
2021-03-23,SAN MARTIN,5561,24848,2154,32563,22847,111126,12652,146625
2021-01-05,TACNA,1882,12979,3,14864,5331,84929,6,90260
2021-01-06,TACNA,1895,12982,12,14889,5351,85460,24,90811
2021-01-07,TACNA,1907,13004,14,14925,5392,85460,28,90852
2021-01-08,TACNA,1924,13006,18,14948,5414,85995,36,91409
2021-01-09,TACNA,1970,13024,21,15015,5470,86521,42,91991
2021-01-10,TACNA,1970,13029,25,15024,5470,86521,50,91991
2021-01-11,TACNA,2001,13056,29,15086,5500,87056,58,92556
2021-01-12,TACNA,2014,13072,30,15116,5519,87591,277,93387
2021-01-13,TACNA,2044,13132,41,15217,5596,88112,374,94082
2021-01-14,TACNA,2070,13172,93,15335,5665,88574,812,95051
2021-01-15,TACNA,2120,13213,98,15431,5778,89147,904,95829
2021-01-16,TACNA,2125,13253,105,15483,5779,89779,920,96478
2021-01-17,TACNA,2161,13258,108,15527,5827,90005,954,96786
2021-01-18,TACNA,2192,13296,119,15607,5877,90282,970,97129
2021-01-19,TACNA,2241,13365,140,15746,5979,91028,1013,98020
2021-01-20,TACNA,2269,13413,154,15836,6059,91693,1081,98833
2021-01-21,TACNA,2295,13464,180,15939,6126,92422,1270,99818
2021-01-22,TACNA,2328,13503,188,16019,6182,92928,1355,100465
2021-01-23,TACNA,2372,13546,200,16118,6295,93429,1430,101154
2021-01-24,TACNA,2372,13557,208,16137,6295,93715,1461,101471
2021-01-25,TACNA,2419,13597,216,16232,6387,94001,1528,101916
2021-01-26,TACNA,2455,13720,248,16423,6479,94642,1637,102758
2021-01-27,TACNA,2469,13792,283,16544,6571,95358,1684,103613
2021-01-28,TACNA,2533,13852,319,16704,6715,96038,1806,104559
2021-01-29,TACNA,2574,13895,348,16817,6812,96547,2014,105373
2021-01-30,TACNA,2613,13967,379,16959,6912,96914,2198,106024
2021-01-31,TACNA,2613,13974,394,16981,6912,97170,2309,106391
2021-02-01,TACNA,2645,14042,428,17115,6976,97506,2479,106961
2021-02-02,TACNA,2691,14146,461,17298,7065,98203,2646,107914
2021-02-03,TACNA,2732,14219,512,17463,7108,98801,2819,108728
2021-02-04,TACNA,2771,14271,538,17580,7185,99189,3097,109471
2021-02-05,TACNA,2771,14287,593,17651,7185,99469,3408,110062
2021-02-06,TACNA,2826,14331,625,17782,7310,99610,3580,110500
2021-02-07,TACNA,2826,14361,655,17842,7310,99748,3651,110709
2021-02-08,TACNA,2842,14387,710,17939,7360,99853,3825,111038
2021-02-09,TACNA,2879,14444,801,18124,7434,100175,4127,111736
2021-02-10,TACNA,2902,14477,865,18244,7484,100518,4586,112588
2021-02-11,TACNA,2918,14519,1016,18453,7525,100858,5052,113435
2021-02-12,TACNA,2918,14538,1098,18554,7525,101091,5513,114129
2021-02-13,TACNA,2937,14583,1201,18721,7569,101298,6046,114913
2021-02-14,TACNA,2950,14594,1248,18792,7615,101371,6185,115171
2021-02-15,TACNA,2967,14604,1358,18929,7662,101634,6686,115982
2021-02-16,TACNA,2986,14610,1463,19059,7721,101718,7169,116608
2021-02-17,TACNA,2994,14653,1552,19199,7767,101832,7638,117237
2021-02-18,TACNA,3012,14686,1640,19338,7822,101955,8156,117933
2021-02-19,TACNA,3027,14698,1689,19414,7867,102072,8699,118638
2021-02-20,TACNA,3063,14721,1759,19543,7875,102190,9018,119083
2021-02-21,TACNA,3063,14730,1795,19588,7875,102238,9105,119218
2021-02-22,TACNA,3063,14749,1845,19657,7875,102330,9380,119585
2021-02-23,TACNA,3111,14765,1919,19795,7943,102459,9788,120190
2021-02-24,TACNA,3133,14776,1958,19867,7943,102542,10077,120562
2021-02-25,TACNA,3175,14786,2011,19972,7952,102614,10573,121139
2021-02-26,TACNA,3175,14801,2061,20037,7952,102688,10990,121630
2021-02-27,TACNA,3259,14815,2109,20183,8021,102728,11546,122295
2021-02-28,TACNA,3259,14825,2127,20211,8021,102794,11673,122488
2021-03-01,TACNA,3282,14842,2164,20288,8095,102889,12055,123039
2021-03-02,TACNA,3282,14862,2231,20375,8095,102986,12706,123787
2021-03-03,TACNA,3321,14892,2280,20493,8222,103089,13171,124482
2021-03-04,TACNA,3353,14902,2329,20584,8222,103308,13713,125243
2021-03-05,TACNA,3368,14915,2364,20647,8279,103380,14098,125757
2021-03-06,TACNA,3385,14940,2400,20725,8326,103499,14493,126318
2021-03-07,TACNA,3385,14948,2419,20752,8326,103541,14636,126503
2021-03-08,TACNA,3400,14964,2461,20825,8361,103608,15040,127009
2021-03-09,TACNA,3420,14978,2519,20917,8392,103737,15611,127740
2021-03-10,TACNA,3432,14992,2573,20997,8471,103845,16165,128481
2021-03-11,TACNA,3445,15007,2607,21059,8502,103974,16831,129307
2021-03-12,TACNA,3445,15021,2646,21112,8503,103991,17353,129847
2021-03-13,TACNA,3445,15027,2674,21146,8503,104126,17824,130453
2021-03-14,TACNA,3467,15027,2685,21179,8503,104156,18042,130701
2021-03-15,TACNA,3477,15038,2726,21241,8560,104321,18486,131367
2021-03-16,TACNA,3477,15052,2766,21295,8567,104457,18999,132023
2021-03-17,TACNA,3506,15064,2818,21388,8646,104542,19415,132603
2021-03-18,TACNA,3513,15071,2841,21425,8646,104626,19589,132861
2021-03-19,TACNA,3518,15079,2869,21466,8676,104761,19871,133308
2021-03-20,TACNA,3518,15089,2893,21500,8677,104872,20104,133653
2021-03-21,TACNA,3523,15091,2909,21523,8700,104882,20219,133801
2021-03-22,TACNA,3528,15100,2933,21561,8719,105005,20579,134303
2021-03-23,TACNA,3541,15106,2961,21608,8762,105088,21053,134903
2021-01-05,TUMBES,916,8603,4,9523,7099,39123,8,46222
2021-01-06,TUMBES,939,8605,4,9548,7392,39174,8,46566
2021-01-07,TUMBES,942,8606,4,9552,7493,39174,8,46667
2021-01-08,TUMBES,961,8607,5,9573,7650,39225,10,46875
2021-01-09,TUMBES,982,8608,5,9595,7961,39225,10,47186
2021-01-10,TUMBES,982,8608,7,9597,7961,39225,14,47186
2021-01-11,TUMBES,997,8609,9,9615,7995,39276,18,47271
2021-01-12,TUMBES,1031,8609,15,9655,8201,39276,164,47641
2021-01-13,TUMBES,1051,8614,16,9681,8448,39302,91,47841
2021-01-14,TUMBES,1072,8616,46,9734,8465,39356,206,48027
2021-01-15,TUMBES,1111,8620,50,9781,8690,39413,213,48316
2021-01-16,TUMBES,1138,8625,50,9813,8849,39474,217,48540
2021-01-17,TUMBES,1138,8630,53,9821,8855,39482,221,48558
2021-01-18,TUMBES,1202,8632,56,9890,9194,39553,252,48999
2021-01-19,TUMBES,1202,8633,62,9897,9194,39583,283,49060
2021-01-20,TUMBES,1276,8639,64,9979,9545,39641,292,49478
2021-01-21,TUMBES,1289,8647,73,10009,9545,39810,339,49694
2021-01-22,TUMBES,1302,8648,77,10027,9925,39862,355,50142
2021-01-23,TUMBES,1323,8649,79,10051,10166,39908,361,50435
2021-01-24,TUMBES,1341,8652,81,10074,10187,39918,366,50471
2021-01-25,TUMBES,1407,8653,83,10143,10479,39928,389,50796
2021-01-26,TUMBES,1446,8660,88,10194,10771,39953,409,51133
2021-01-27,TUMBES,1477,8666,100,10243,11063,39986,423,51472
2021-01-28,TUMBES,1511,8666,132,10309,11314,40024,458,51796
2021-01-29,TUMBES,1511,8672,146,10329,11423,40176,596,52195
2021-01-30,TUMBES,1569,8674,166,10409,11814,40199,916,52929
2021-01-31,TUMBES,1569,8676,177,10422,11814,40248,984,53046
2021-02-01,TUMBES,1605,8681,182,10468,11967,40270,1026,53263
2021-02-02,TUMBES,1605,8684,196,10485,11967,40315,1180,53462
2021-02-03,TUMBES,1667,8687,204,10558,12305,40356,1255,53916
2021-02-04,TUMBES,1674,8690,219,10583,12354,40445,1322,54121
2021-02-05,TUMBES,1676,8692,231,10599,12365,40504,1429,54298
2021-02-06,TUMBES,1681,8692,234,10607,12394,40550,1445,54389
2021-02-07,TUMBES,1722,8692,237,10651,12609,40554,1456,54619
2021-02-08,TUMBES,1769,8693,239,10701,12844,40577,1485,54906
2021-02-09,TUMBES,1771,8694,245,10710,12851,40592,1497,54940
2021-02-10,TUMBES,1799,8696,261,10756,12994,40646,1687,55327
2021-02-11,TUMBES,1867,8701,286,10854,13374,40725,1878,55977
2021-02-12,TUMBES,1874,8701,306,10881,13374,40773,2084,56231
2021-02-13,TUMBES,1935,8703,345,10983,13619,40814,2270,56703
2021-02-14,TUMBES,1935,8705,345,10985,13619,40816,2374,56809
2021-02-15,TUMBES,1948,8705,360,11013,13684,40833,2450,56967
2021-02-16,TUMBES,1962,8705,387,11054,13763,40874,2680,57317
2021-02-17,TUMBES,1989,8707,402,11098,13897,40904,2730,57531
2021-02-18,TUMBES,1992,8708,440,11140,13909,40939,3035,57883
2021-02-19,TUMBES,2053,8710,450,11213,14311,40962,3172,58445
2021-02-20,TUMBES,2053,8711,461,11225,14343,40969,3268,58580
2021-02-21,TUMBES,2053,8711,465,11229,14343,40970,3278,58591
2021-02-22,TUMBES,2084,8723,485,11292,14526,41044,3410,58980
2021-02-23,TUMBES,2105,8725,518,11348,14707,41072,3675,59454
2021-02-24,TUMBES,2183,8729,572,11484,15037,41124,4013,60174
2021-02-25,TUMBES,2185,8731,604,11520,15095,41162,4247,60504
2021-02-26,TUMBES,2226,8737,638,11601,15315,41287,4474,61076
2021-02-27,TUMBES,2261,8737,676,11674,15540,41334,4774,61648
2021-02-28,TUMBES,2293,8737,684,11714,15732,41338,4791,61861
2021-03-01,TUMBES,2338,8737,710,11785,15944,41348,4965,62257
2021-03-02,TUMBES,2339,8738,735,11812,15949,41363,5075,62387
2021-03-03,TUMBES,2339,8738,755,11832,16120,41381,5314,62815
2021-03-04,TUMBES,2420,8739,796,11955,16125,41389,5647,63161
2021-03-05,TUMBES,2420,8740,811,11971,16125,41395,5780,63300
2021-03-06,TUMBES,2427,8741,822,11990,16257,41414,5973,63644
2021-03-07,TUMBES,2427,8741,830,11998,16257,41424,5993,63674
2021-03-08,TUMBES,2430,8741,849,12020,16260,41442,6067,63769
2021-03-09,TUMBES,2446,8743,884,12073,16322,41647,6230,64199
2021-03-10,TUMBES,2465,8745,900,12110,16380,41955,6387,64722
2021-03-11,TUMBES,2469,8752,945,12166,16393,42040,6700,65133
2021-03-12,TUMBES,2470,8753,981,12204,16751,42200,7137,66088
2021-03-13,TUMBES,2470,8754,1004,12228,16751,42272,7337,66360
2021-03-14,TUMBES,2567,8754,1014,12335,16817,42277,7423,66517
2021-03-15,TUMBES,2568,8756,1055,12379,16866,42320,7674,66860
2021-03-16,TUMBES,2627,8757,1094,12478,17068,42395,7876,67339
2021-03-17,TUMBES,2627,8758,1110,12495,17099,42401,7951,67451
2021-03-18,TUMBES,2652,8758,1153,12563,17182,42476,8212,67870
2021-03-19,TUMBES,2710,8758,1187,12655,17431,42505,8346,68282
2021-03-20,TUMBES,2710,8761,1228,12699,17432,42525,8637,68594
2021-03-21,TUMBES,2711,8761,1253,12725,17432,42527,8695,68654
2021-03-22,TUMBES,2774,8762,1289,12825,17635,42635,8863,69133
2021-03-23,TUMBES,2837,8762,1364,12963,17636,42642,9111,69389
2021-01-08,UCAYALI,1106,19541,1,20648,5752,62621,2,68373
2021-01-09,UCAYALI,1111,19549,1,20661,5799,62621,2,68420
2021-01-10,UCAYALI,1111,19550,1,20662,5799,62621,2,68420
2021-01-11,UCAYALI,1115,19557,1,20673,5829,62621,2,68450
2021-01-12,UCAYALI,1118,19562,2,20682,5852,62621,11,68484
2021-01-13,UCAYALI,1123,19597,22,20742,5887,62763,32,68682
2021-01-14,UCAYALI,1126,19615,26,20767,5887,62763,64,68714
2021-01-15,UCAYALI,1153,19634,26,20813,6014,62967,67,69048
2021-01-16,UCAYALI,1165,19691,35,20891,6060,63225,71,69356
2021-01-17,UCAYALI,1168,19723,35,20926,6083,63359,71,69513
2021-01-18,UCAYALI,1191,19740,35,20966,6150,63556,74,69780
2021-01-19,UCAYALI,1205,19761,35,21001,6176,63751,77,70004
2021-01-20,UCAYALI,1206,19781,38,21025,6185,63975,108,70268
2021-01-21,UCAYALI,1219,19807,86,21112,6230,64250,221,70701
2021-01-22,UCAYALI,1232,19826,92,21150,6288,64426,225,70939
2021-01-23,UCAYALI,1246,19842,99,21187,6346,64603,235,71184
2021-01-24,UCAYALI,1254,19851,107,21212,6396,64723,251,71370
2021-01-25,UCAYALI,1265,19864,110,21239,6449,64843,255,71547
2021-01-26,UCAYALI,1276,19910,117,21303,6502,65234,274,72010
2021-01-27,UCAYALI,1283,19935,119,21337,6555,65556,282,72393
2021-01-28,UCAYALI,1291,19988,133,21412,6584,65858,293,72735
2021-01-29,UCAYALI,1291,20017,136,21444,6655,66178,314,73147
2021-01-30,UCAYALI,1307,20044,149,21500,6772,66422,324,73518
2021-01-31,UCAYALI,1307,20056,149,21512,6772,66682,334,73788
2021-02-01,UCAYALI,1310,20103,152,21565,6801,67005,348,74154
2021-02-02,UCAYALI,1335,20147,164,21646,6894,67321,361,74576
2021-02-03,UCAYALI,1350,20162,172,21684,6864,67532,385,74781
2021-02-04,UCAYALI,1354,20197,205,21756,6892,67814,452,75158
2021-02-05,UCAYALI,1360,20200,215,21775,6928,68024,512,75464
2021-02-06,UCAYALI,1368,20228,217,21813,6966,68085,518,75569
2021-02-07,UCAYALI,1368,20247,241,21856,6966,68439,593,75998
2021-02-08,UCAYALI,1372,20252,258,21882,7003,68665,651,76319
2021-02-09,UCAYALI,1377,20268,272,21917,7029,68844,729,76602
2021-02-10,UCAYALI,1385,20290,304,21979,7083,69171,850,77104
2021-02-11,UCAYALI,1388,20320,317,22025,7115,69383,978,77476
2021-02-12,UCAYALI,1391,20320,329,22040,7160,69600,1084,77844
2021-02-13,UCAYALI,1395,20340,339,22074,7187,69771,1163,78121
2021-02-14,UCAYALI,1395,20343,342,22080,7187,69783,1189,78159
2021-02-15,UCAYALI,1395,20363,352,22110,7187,69997,1256,78440
2021-02-16,UCAYALI,1400,20368,378,22146,7229,70300,1357,78886
2021-02-17,UCAYALI,1407,20431,397,22235,7264,70667,1472,79403
2021-02-18,UCAYALI,1421,20445,411,22277,7308,70840,1549,79697
2021-02-19,UCAYALI,1428,20456,436,22320,7340,71047,1644,80031
2021-02-20,UCAYALI,1429,20486,459,22374,7357,71264,1791,80412
2021-02-21,UCAYALI,1429,20492,476,22397,7357,71349,1845,80551
2021-02-22,UCAYALI,1429,20521,503,22453,7357,71619,1952,80928
2021-02-23,UCAYALI,1437,20556,528,22521,7382,71883,2092,81357
2021-02-24,UCAYALI,1445,20566,563,22574,7421,72124,2248,81793
2021-02-25,UCAYALI,1459,20590,587,22636,7440,72395,2381,82216
2021-02-26,UCAYALI,1460,20609,620,22689,7467,72596,2507,82570
2021-02-27,UCAYALI,1465,20633,652,22750,7489,72794,2635,82918
2021-02-28,UCAYALI,1469,20649,658,22776,7514,72857,2674,83045
2021-03-01,UCAYALI,1477,20665,689,22831,7521,73036,2851,83408
2021-03-02,UCAYALI,1478,20706,737,22921,7540,73340,3079,83959
2021-03-03,UCAYALI,1484,20727,769,22980,7556,73540,3286,84382
2021-03-04,UCAYALI,1493,20763,830,23086,7575,73790,3533,84898
2021-03-05,UCAYALI,1499,20792,887,23178,7592,74100,3796,85488
2021-03-06,UCAYALI,1507,20809,927,23243,7602,74262,4029,85893
2021-03-07,UCAYALI,1526,20817,947,23290,7639,74345,4092,86076
2021-03-08,UCAYALI,1527,20829,999,23355,7642,74562,4402,86606
2021-03-09,UCAYALI,1536,20882,1066,23484,7666,74960,4640,87266
2021-03-10,UCAYALI,1560,20903,1156,23619,7666,75124,4986,87776
2021-03-11,UCAYALI,1582,20970,1235,23787,7700,75546,5288,88534
2021-03-12,UCAYALI,1599,21007,1294,23900,7742,75820,5495,89057
2021-03-13,UCAYALI,1599,21030,1423,24052,7742,76230,6013,89985
2021-03-14,UCAYALI,1599,21032,1458,24089,7742,76266,6142,90150
2021-03-15,UCAYALI,1628,21047,1562,24237,7833,76450,6528,90811
2021-03-16,UCAYALI,1642,21084,1671,24397,7856,76703,6921,91480
2021-03-17,UCAYALI,1656,21105,1808,24569,7898,76879,7383,92160
2021-03-18,UCAYALI,1684,21135,1936,24755,7979,77196,7826,93001
2021-03-19,UCAYALI,1684,21155,2054,24893,7979,77361,8160,93500
2021-03-20,UCAYALI,1704,21170,2191,25065,8036,77519,8642,94197
2021-03-21,UCAYALI,1717,21171,2236,25124,8087,77570,8844,94501
2021-03-22,UCAYALI,1717,21197,2364,25278,8088,77807,9214,95109
2021-03-23,UCAYALI,1723,21216,2579,25518,8112,77990,9771,95873
